"","isActive","isRookie","namePlayer","idPlayer","countSeasons","yearSeasonFirst","yearSeasonLast"
"1",FALSE,FALSE,"Alaa Abdelnaby",76001,4,1990,1994
"2",FALSE,FALSE,"Zaid Abdul-Aziz",76002,9,1968,1977
"3",FALSE,FALSE,"Kareem Abdul-Jabbar",76003,19,1969,1988
"4",FALSE,FALSE,"Mahmoud Abdul-Rauf",51,10,1990,2000
"5",FALSE,FALSE,"Tariq Abdul-Wahad",1505,6,1997,2003
"6",FALSE,FALSE,"Shareef Abdur-Rahim",949,11,1996,2007
"7",FALSE,FALSE,"Tom Abernethy",76005,4,1976,1980
"8",FALSE,FALSE,"Forest Able",76006,0,1956,1956
"9",FALSE,FALSE,"John Abramovic",76007,1,1946,1947
"10",FALSE,FALSE,"Alex Abrines",203518,2,2016,2018
"11",TRUE,TRUE,"Precious Achiuwa",1630173,0,2020,2020
"12",FALSE,FALSE,"Alex Acker",101165,3,2005,2008
"13",FALSE,FALSE,"Donald Ackerman",76008,0,1953,1953
"14",FALSE,FALSE,"Mark Acres",76009,5,1987,1992
"15",FALSE,FALSE,"Charles Acton",76010,0,1967,1967
"16",FALSE,FALSE,"Quincy Acy",203112,6,2012,2018
"17",FALSE,FALSE,"Alvan Adams",76011,12,1975,1987
"18",FALSE,FALSE,"Don Adams",76012,6,1970,1976
"19",FALSE,FALSE,"Hassan Adams",200801,2,2006,2008
"20",FALSE,FALSE,"Jaylen Adams",1629121,2,2018,2020
"21",FALSE,FALSE,"Jordan Adams",203919,1,2014,2015
"22",FALSE,FALSE,"Michael Adams",149,10,1985,1995
"23",TRUE,FALSE,"Steven Adams",203500,7,2013,2020
"24",FALSE,FALSE,"Rafael Addison",912,10,1986,1996
"25",TRUE,FALSE,"Bam Adebayo",1628389,3,2017,2020
"26",FALSE,FALSE,"Deng Adel",1629061,0,2018,2018
"27",FALSE,FALSE,"Rick Adelman",76015,6,1968,1974
"28",FALSE,FALSE,"Jeff Adrien",202399,4,2010,2014
"29",FALSE,FALSE,"Arron Afflalo",201167,10,2007,2017
"30",FALSE,FALSE,"Maurice Ager",200772,4,2006,2010
"31",FALSE,FALSE,"Mark Aguirre",76016,12,1981,1993
"32",FALSE,FALSE,"Blake Ahearn",201336,4,2007,2011
"33",FALSE,FALSE,"Danny Ainge",76017,13,1981,1994
"34",FALSE,FALSE,"Alexis Ajinca",201582,9,2008,2017
"35",FALSE,FALSE,"Henry Akin",76018,1,1966,1967
"36",FALSE,FALSE,"Josh Akognon",203006,0,2012,2012
"37",FALSE,FALSE,"DeVaughn Akoon-Purcell",1629152,0,2018,2018
"38",FALSE,FALSE,"Solomon Alabi",202374,1,2010,2011
"39",FALSE,FALSE,"Mark Alarie",76019,4,1986,1990
"40",FALSE,FALSE,"Gary Alcorn",76020,1,1959,1960
"41",FALSE,FALSE,"Furkan Aldemir",203128,0,2014,2014
"42",FALSE,FALSE,"Cole Aldrich",202332,7,2010,2017
"43",FALSE,FALSE,"LaMarcus Aldridge",200746,14,2006,2020
"44",FALSE,FALSE,"Chuck Aleksinas",76021,0,1984,1984
"45",FALSE,FALSE,"Cliff Alexander",1626146,0,2015,2015
"46",FALSE,FALSE,"Cory Alexander",724,9,1995,2004
"47",FALSE,FALSE,"Courtney Alexander",2042,3,2000,2003
"48",FALSE,FALSE,"Gary Alexander",76022,0,1993,1993
"49",FALSE,FALSE,"Joe Alexander",201570,1,2008,2009
"50",FALSE,FALSE,"Kyle Alexander",1629734,0,2019,2019
"51",TRUE,TRUE,"Ty-Shon Alexander",1630234,0,2020,2020
"52",FALSE,FALSE,"Victor Alexander",2349,10,1991,2001
"53",TRUE,FALSE,"Nickeil Alexander-Walker",1629638,1,2019,2020
"54",FALSE,FALSE,"Steve Alford",76024,3,1987,1990
"55",FALSE,FALSE,"Rawle Alkins",1628959,0,2018,2018
"56",FALSE,FALSE,"Bob Allen",76028,0,1968,1968
"57",TRUE,FALSE,"Grayson Allen",1628960,2,2018,2020
"58",TRUE,FALSE,"Jarrett Allen",1628386,3,2017,2020
"59",FALSE,FALSE,"Jerome Allen",706,1,1995,1996
"60",FALSE,FALSE,"Kadeem Allen",1628443,2,2017,2019
"61",FALSE,FALSE,"Lavoy Allen",202730,5,2011,2016
"62",FALSE,FALSE,"Lucius Allen",76027,9,1969,1978
"63",FALSE,FALSE,"Malik Allen",2124,9,2001,2010
"64",FALSE,FALSE,"Randy Allen",76025,1,1988,1989
"65",FALSE,FALSE,"Ray Allen",951,17,1996,2013
"66",FALSE,FALSE,"Tony Allen",2754,13,2004,2017
"67",FALSE,FALSE,"Odis Allison",76029,0,1971,1971
"68",FALSE,FALSE,"Lance Allred",200984,0,2007,2007
"69",FALSE,FALSE,"Darrell Allums",76030,0,1980,1980
"70",FALSE,FALSE,"Morris Almond",201165,4,2007,2011
"71",FALSE,FALSE,"Derrick Alston",308,2,1994,1996
"72",FALSE,FALSE,"Rafer Alston",1747,10,1999,2009
"73",FALSE,FALSE,"Peter Aluma",1824,0,1998,1998
"74",FALSE,FALSE,"John Amaechi",680,7,1995,2002
"75",FALSE,FALSE,"Ashraf Amaya",732,1,1995,1996
"76",TRUE,FALSE,"Al-Farouq Aminu",202329,10,2010,2020
"77",FALSE,FALSE,"Lou Amundson",200811,9,2006,2015
"78",FALSE,FALSE,"Bob Anderegg",76034,0,1959,1959
"79",FALSE,FALSE,"Chris Andersen",2365,15,2001,2016
"80",FALSE,FALSE,"David Andersen",2431,1,2009,2010
"81",FALSE,FALSE,"Alan Anderson",101187,11,2005,2016
"82",FALSE,FALSE,"Antonio Anderson",202079,0,2009,2009
"83",FALSE,FALSE,"Cliff Anderson",76035,3,1967,1970
"84",FALSE,FALSE,"Daniel Anderson",76036,1,1974,1975
"85",FALSE,FALSE,"Derek Anderson",1507,10,1997,2007
"86",FALSE,FALSE,"Dwight Anderson",76037,0,1982,1982
"87",FALSE,FALSE,"Eric Anderson",944,1,1992,1993
"88",FALSE,FALSE,"Greg Anderson",246,10,1987,1997
"89",FALSE,FALSE,"James Anderson",202341,5,2010,2015
"90",FALSE,FALSE,"Jerome Anderson",76040,1,1975,1976
"91",FALSE,FALSE,"Justin Anderson",1626147,4,2015,2019
"92",FALSE,FALSE,"Kenny Anderson",72,13,1991,2004
"93",FALSE,FALSE,"Kim Anderson",76041,0,1978,1978
"94",TRUE,FALSE,"Kyle Anderson",203937,6,2014,2020
"95",FALSE,FALSE,"Michael Anderson",76042,0,1988,1988
"96",FALSE,FALSE,"Mitchell Anderson",76043,2,1982,1984
"97",FALSE,FALSE,"Nick Anderson",98,13,1989,2002
"98",FALSE,FALSE,"Richard Anderson",76045,7,1982,1989
"99",FALSE,FALSE,"Ron Anderson",76046,9,1984,1993
"100",FALSE,FALSE,"Ryan Anderson",201583,11,2008,2019
"101",FALSE,FALSE,"Shandon Anderson",1000,9,1996,2005
"102",FALSE,FALSE,"Willie Anderson",335,8,1988,1996
"103",FALSE,FALSE,"Wally Anderzunas",76048,0,1969,1969
"104",FALSE,FALSE,"Martynas Andriuskevicius",101149,1,2005,2006
"105",FALSE,FALSE,"Don Anielak",76049,0,1954,1954
"106",FALSE,FALSE,"Ike Anigbogu",1628387,1,2017,2018
"107",FALSE,FALSE,"Michael Ansley",76050,2,1989,1991
"108",FALSE,FALSE,"Chris Anstey",1512,2,1997,1999
"109",TRUE,FALSE,"Giannis Antetokounmpo",203507,7,2013,2020
"110",TRUE,FALSE,"Kostas Antetokounmpo",1628961,2,2018,2020
"111",TRUE,FALSE,"Thanasis Antetokounmpo",203648,5,2015,2020
"112",TRUE,FALSE,"Carmelo Anthony",2546,17,2003,2020
"113",TRUE,TRUE,"Cole Anthony",1630175,0,2020,2020
"114",FALSE,FALSE,"Greg Anthony",21,10,1991,2001
"115",FALSE,FALSE,"Joel Anthony",201202,9,2007,2016
"116",FALSE,FALSE,"Pero Antic",203544,1,2013,2014
"117",TRUE,FALSE,"OG Anunoby",1628384,3,2017,2020
"118",FALSE,FALSE,"Keith Appling",203951,0,2015,2015
"119",FALSE,FALSE,"Rafael Araujo",2737,2,2004,2006
"120",FALSE,FALSE,"Stacey Arceneaux",76053,0,1961,1961
"121",FALSE,FALSE,"Nate Archibald",76054,13,1970,1983
"122",FALSE,FALSE,"Robert Archibald",2425,1,2002,2003
"123",TRUE,FALSE,"Ryan Arcidiacono",1627853,3,2017,2020
"124",FALSE,FALSE,"Jim Ard",76055,3,1974,1977
"125",FALSE,FALSE,"Gilbert Arenas",2240,10,2001,2011
"126",TRUE,FALSE,"Trevor Ariza",2772,16,2004,2020
"127",FALSE,FALSE,"Paul Arizin",76056,11,1950,1961
"128",FALSE,FALSE,"Joe Arlauckas",76057,0,1987,1987
"129",FALSE,FALSE,"B.J. Armstrong",769,10,1989,1999
"130",FALSE,FALSE,"Bob Armstrong",76061,0,1956,1956
"131",FALSE,FALSE,"Brandon Armstrong",2220,2,2001,2003
"132",FALSE,FALSE,"Darrell Armstrong",353,13,1994,2007
"133",FALSE,FALSE,"Hilton Armstrong",200756,7,2006,2013
"134",FALSE,FALSE,"Paul Armstrong",76060,2,1948,1950
"135",FALSE,FALSE,"Tate Armstrong",76059,1,1977,1978
"136",FALSE,FALSE,"Jesse Arnelle",76062,0,1955,1955
"137",FALSE,FALSE,"Jay Arnette",76063,2,1963,1965
"138",FALSE,FALSE,"Bob Arnzen",76064,0,1970,1970
"139",FALSE,FALSE,"Carlos Arroyo",2306,9,2001,2010
"140",FALSE,FALSE,"Darrell Arthur",201589,9,2008,2017
"141",FALSE,FALSE,"John Arthurs",76065,0,1969,1969
"142",FALSE,FALSE,"Jamel Artis",1628503,0,2017,2017
"143",FALSE,FALSE,"Omer Asik",201600,7,2010,2017
"144",FALSE,FALSE,"Vincent Askew",355,10,1987,1997
"145",FALSE,FALSE,"Keith Askins",173,8,1990,1998
"146",FALSE,FALSE,"Don Asmonga",76068,0,1953,1953
"147",FALSE,FALSE,"Richard Atha",76069,2,1955,1957
"148",FALSE,FALSE,"Chucky Atkins",1088,10,1999,2009
"149",FALSE,FALSE,"Alvin Attles",76070,10,1960,1970
"150",FALSE,FALSE,"Chet Aubuchon",76071,0,1946,1946
"151",FALSE,FALSE,"Stacey Augmon",278,14,1991,2005
"152",TRUE,FALSE,"D.J. Augustin",201571,12,2008,2020
"153",FALSE,FALSE,"James Augustine",200788,1,2006,2007
"154",FALSE,FALSE,"Ike Austin",1134,10,1991,2001
"155",FALSE,FALSE,"John Austin",76073,0,1966,1966
"156",FALSE,FALSE,"Ken Austin",76074,0,1983,1983
"157",TRUE,TRUE,"Deni Avdija",1630166,0,2020,2020
"158",FALSE,FALSE,"Anthony Avent",138,7,1992,1999
"159",FALSE,FALSE,"William Averitt",76076,1,1976,1977
"160",FALSE,FALSE,"William Avery",1895,3,1999,2002
"161",FALSE,FALSE,"Dennis Awtrey",76078,11,1970,1981
"162",FALSE,FALSE,"Gustavo Ayon",202970,2,2011,2013
"163",FALSE,FALSE,"Jeff Ayres",201965,6,2009,2015
"164",TRUE,FALSE,"Deandre Ayton",1629028,2,2018,2020
"165",FALSE,FALSE,"Kelenna Azubuike",101235,5,2006,2011
"166",TRUE,TRUE,"Udoka Azubuike",1628962,0,2020,2020
"167",FALSE,FALSE,"Chris Babb",203569,1,2013,2014
"168",FALSE,FALSE,"Luke Babbitt",202337,7,2010,2017
"169",FALSE,FALSE,"Milos Babic",76079,1,1990,1991
"170",FALSE,FALSE,"Johnny Bach",76080,0,1948,1948
"171",TRUE,FALSE,"Dwayne Bacon",1628407,3,2017,2020
"172",FALSE,FALSE,"Jim Baechtold",76081,4,1952,1956
"173",FALSE,FALSE,"Dalibor Bagaric",2053,2,2000,2002
"174",FALSE,FALSE,"John Bagley",76082,11,1982,1993
"175",TRUE,FALSE,"Marvin Bagley III",1628963,2,2018,2020
"176",FALSE,FALSE,"Carl Bailey",76084,0,1981,1981
"177",FALSE,FALSE,"Gus Bailey",76083,5,1974,1979
"178",FALSE,FALSE,"James Bailey",76085,8,1979,1987
"179",FALSE,FALSE,"Thurl Bailey",1847,15,1983,1998
"180",FALSE,FALSE,"Toby Bailey",1753,4,1998,2002
"181",FALSE,FALSE,"Cameron Bairstow",203946,1,2014,2015
"182",FALSE,FALSE,"Mark Baker",1858,0,1998,1998
"183",FALSE,FALSE,"Maurice Baker",2486,2,2002,2004
"184",FALSE,FALSE,"Norm Baker",76089,0,1946,1946
"185",FALSE,FALSE,"Ron Baker",1627758,2,2016,2018
"186",FALSE,FALSE,"Vin Baker",452,12,1993,2005
"187",FALSE,FALSE,"Wade Baldwin IV",1627735,2,2016,2018
"188",FALSE,FALSE,"Renaldo Balkman",200764,5,2006,2011
"189",FALSE,FALSE,"Cedric Ball",76090,0,1990,1990
"190",TRUE,TRUE,"LaMelo Ball",1630163,0,2020,2020
"191",TRUE,FALSE,"Lonzo Ball",1628366,3,2017,2020
"192",FALSE,FALSE,"Greg Ballard",76091,11,1977,1988
"193",FALSE,FALSE,"Herschel Baltimore",76092,0,1946,1946
"194",TRUE,FALSE,"Mo Bamba",1628964,2,2018,2020
"195",TRUE,TRUE,"Desmond Bane",1630217,0,2020,2020
"196",FALSE,FALSE,"Gene Banks",76093,5,1981,1986
"197",FALSE,FALSE,"Marcus Banks",2556,7,2003,2010
"198",FALSE,FALSE,"Ken Bannister",76094,6,1984,1990
"199",FALSE,FALSE,"Mike Bantom",76095,8,1973,1981
"200",FALSE,FALSE,"John Barber",76096,0,1956,1956
"201",FALSE,FALSE,"Leandro Barbosa",2571,13,2003,2016
"202",FALSE,FALSE,"Stephen Bardo",76097,4,1991,1995
"203",FALSE,FALSE,"J.J. Barea",200826,13,2006,2019
"204",FALSE,FALSE,"Andrea Bargnani",200745,9,2006,2015
"205",FALSE,FALSE,"Cliff Barker",76098,2,1949,1951
"206",FALSE,FALSE,"Tom Barker",76099,2,1976,1978
"207",FALSE,FALSE,"Charles Barkley",787,15,1984,1999
"208",FALSE,FALSE,"Erick Barkley",2057,2,2000,2002
"209",FALSE,FALSE,"Don Barksdale",76102,3,1951,1954
"210",TRUE,FALSE,"Harrison Barnes",203084,8,2012,2020
"211",FALSE,FALSE,"Harry Barnes",76103,0,1968,1968
"212",FALSE,FALSE,"Jim Barnes",76105,6,1964,1970
"213",FALSE,FALSE,"Marvin Barnes",76104,3,1976,1979
"214",FALSE,FALSE,"Matt Barnes",2440,14,2002,2016
"215",FALSE,FALSE,"Dick Barnett",76107,14,1959,1973
"216",FALSE,FALSE,"Jim Barnett",76106,10,1966,1976
"217",FALSE,FALSE,"John Barnhill",76108,6,1962,1968
"218",FALSE,FALSE,"Norton Barnhill",76109,0,1976,1976
"219",FALSE,FALSE,"Leo Barnhorst",76110,4,1949,1953
"220",FALSE,FALSE,"John Barr",76111,0,1946,1946
"221",FALSE,FALSE,"Mike Barr",76112,0,1976,1976
"222",FALSE,FALSE,"Thomas Barr",76113,0,1970,1970
"223",FALSE,FALSE,"Andre Barrett",2857,3,2004,2007
"224",FALSE,FALSE,"Ernie Barrett",76114,2,1953,1955
"225",TRUE,FALSE,"RJ Barrett",1629628,1,2019,2020
"226",FALSE,FALSE,"Earl Barron",2853,9,2005,2014
"227",FALSE,FALSE,"Dana Barros",344,14,1989,2003
"228",FALSE,FALSE,"Brent Barry",699,13,1995,2008
"229",FALSE,FALSE,"Drew Barry",1003,2,1997,1999
"230",FALSE,FALSE,"Jon Barry",468,13,1992,2005
"231",FALSE,FALSE,"Rick Barry",600013,14,1965,1979
"232",FALSE,FALSE,"Ed Bartels",76117,1,1949,1950
"233",FALSE,FALSE,"Vic Bartolome",76118,0,1971,1971
"234",TRUE,FALSE,"Will Barton",203115,8,2012,2020
"235",FALSE,FALSE,"Eddie Basden",101188,0,2005,2005
"236",FALSE,FALSE,"Jerry Baskerville",76119,0,1975,1975
"237",FALSE,FALSE,"Brandon Bass",101138,11,2005,2016
"238",FALSE,FALSE,"Tim Bassett",76120,3,1976,1979
"239",FALSE,FALSE,"Maceo Baston",1766,6,2002,2008
"240",FALSE,FALSE,"Mengke Bateer",2370,2,2001,2003
"241",FALSE,FALSE,"Billyray Bates",76121,3,1979,1982
"242",TRUE,FALSE,"Keita Bates-Diop",1628966,2,2018,2020
"243",FALSE,FALSE,"Esteban Batista",101212,1,2005,2006
"244",FALSE,FALSE,"Mike Batiste",2471,0,2002,2002
"245",FALSE,FALSE,"Tony Battie",1499,14,1997,2011
"246",FALSE,FALSE,"Shane Battier",2203,12,2001,2013
"247",FALSE,FALSE,"John Battle",174,9,1985,1994
"248",FALSE,FALSE,"Kenny Battle",76123,3,1989,1992
"249",FALSE,FALSE,"Dave Batton",76124,1,1982,1983
"250",TRUE,FALSE,"Nicolas Batum",201587,12,2008,2020
"251",FALSE,FALSE,"Johnny Baum",76125,1,1969,1970
"252",FALSE,FALSE,"Frankie Baumholtz",76126,0,1946,1946
"253",FALSE,FALSE,"Lonny Baxter",2437,3,2002,2005
"254",FALSE,FALSE,"Jerryd Bayless",201573,10,2008,2018
"255",FALSE,FALSE,"Elgin Baylor",76127,13,1958,1971
"256",TRUE,FALSE,"Aron Baynes",203382,8,2012,2020
"257",FALSE,FALSE,"Sergei Bazarevich",76128,0,1994,1994
"258",TRUE,FALSE,"Kent Bazemore",203145,8,2012,2020
"259",TRUE,FALSE,"Darius Bazley",1629647,1,2019,2020
"260",FALSE,FALSE,"Ed Beach",76129,0,1950,1950
"261",TRUE,FALSE,"Bradley Beal",203078,8,2012,2020
"262",FALSE,FALSE,"Butch Beard",76130,9,1969,1978
"263",FALSE,FALSE,"Ralph Beard",76131,1,1949,1950
"264",FALSE,FALSE,"Jerome Beasley",2602,0,2003,2003
"265",TRUE,FALSE,"Malik Beasley",1627736,4,2016,2020
"266",FALSE,FALSE,"Michael Beasley",201563,10,2008,2018
"267",FALSE,FALSE,"Zelmo Beaty",76133,12,1962,1974
"268",FALSE,FALSE,"Rodrigue Beaubois",201958,3,2009,2012
"269",FALSE,FALSE,"Byron Beck",76134,0,1976,1976
"270",FALSE,FALSE,"Corey Beck",1133,3,1995,1998
"271",FALSE,FALSE,"Ernie Beck",76136,7,1953,1960
"272",FALSE,FALSE,"Moe Becker",76137,0,1946,1946
"273",FALSE,FALSE,"William Bedford",76138,6,1986,1992
"274",FALSE,FALSE,"Hank Beenders",76139,2,1946,1948
"275",FALSE,FALSE,"Ron Behagen",76140,6,1973,1979
"276",FALSE,FALSE,"Elmer Behnke",76141,0,1951,1951
"277",FALSE,FALSE,"Marco Belinelli",201158,12,2007,2019
"278",FALSE,FALSE,"Charlie Bell",2294,9,2001,2010
"279",FALSE,FALSE,"Dennis Bell",76142,2,1973,1975
"280",TRUE,FALSE,"Jordan Bell",1628395,3,2017,2020
"281",FALSE,FALSE,"Raja Bell",1952,11,2000,2011
"282",FALSE,FALSE,"Troy Bell",2559,0,2003,2003
"283",FALSE,FALSE,"William Bell",76143,1,1959,1960
"284",FALSE,FALSE,"Walt Bellamy",76144,13,1961,1974
"285",TRUE,FALSE,"DeAndre' Bembry",1627761,4,2016,2020
"286",FALSE,FALSE,"Irv Bemoras",76145,3,1953,1956
"287",FALSE,FALSE,"Leon Benbow",76146,1,1974,1975
"288",FALSE,FALSE,"Dragan Bender",1627733,3,2016,2019
"289",FALSE,FALSE,"Jonathan Bender",1886,10,1999,2009
"290",FALSE,FALSE,"Jerrelle Benimon",203968,0,2014,2014
"291",FALSE,FALSE,"Benoit Benjamin",104,14,1985,1999
"292",FALSE,FALSE,"Corey Benjamin",1736,4,1998,2002
"293",FALSE,FALSE,"Anthony Bennett",203461,3,2013,2016
"294",FALSE,FALSE,"Elmer Bennett",1120,2,1994,1996
"295",FALSE,FALSE,"Mario Bennett",712,7,1995,2002
"296",FALSE,FALSE,"Mel Bennett",76151,5,1976,1981
"297",FALSE,FALSE,"Tony Bennett",76148,2,1992,1994
"298",FALSE,FALSE,"Winston Bennett",76152,2,1989,1991
"299",FALSE,FALSE,"David Benoit",128,9,1991,2000
"300",FALSE,FALSE,"Keith Benson",202728,0,2011,2011
"301",FALSE,FALSE,"Kent Benson",76154,10,1977,1987
"302",FALSE,FALSE,"Ben Bentil",1627791,0,2016,2016
"303",FALSE,FALSE,"Gene Berce",76155,0,1949,1949
"304",FALSE,FALSE,"Gary Bergen",76156,0,1956,1956
"305",FALSE,FALSE,"Ricky Berry",76157,0,1988,1988
"306",FALSE,FALSE,"Walter Berry",76158,2,1986,1988
"307",FALSE,FALSE,"Dairis Bertans",1629541,0,2018,2018
"308",TRUE,FALSE,"Davis Bertans",202722,4,2016,2020
"309",FALSE,FALSE,"Del Beshore",76159,1,1978,1979
"310",FALSE,FALSE,"Travis Best",696,9,1995,2004
"311",TRUE,FALSE,"Patrick Beverley",201976,8,2012,2020
"312",TRUE,TRUE,"Saddiq Bey",1630180,0,2020,2020
"313",TRUE,TRUE,"Tyler Bey",1630189,0,2020,2020
"314",FALSE,FALSE,"Sim Bhullar",204021,0,2014,2014
"315",FALSE,FALSE,"Al Bianchi",76160,9,1956,1965
"316",FALSE,FALSE,"Hank Biasatti",76161,0,1946,1946
"317",FALSE,FALSE,"Henry Bibby",76162,8,1972,1980
"318",FALSE,FALSE,"Mike Bibby",1710,13,1998,2011
"319",FALSE,FALSE,"Ed Biedenbach",76163,0,1968,1968
"320",FALSE,FALSE,"Andris Biedrins",2740,9,2004,2013
"321",FALSE,FALSE,"Don Bielke",76164,0,1955,1955
"322",FALSE,FALSE,"Bob Bigelow",76165,3,1975,1978
"323",FALSE,FALSE,"Chauncey Billups",1497,16,1997,2013
"324",FALSE,FALSE,"Dave Bing",76166,11,1966,1977
"325",FALSE,FALSE,"Joe Binion",76167,0,1986,1986
"326",TRUE,FALSE,"Khem Birch",203920,3,2017,2020
"327",FALSE,FALSE,"Jabari Bird",1628444,0,2017,2017
"328",FALSE,FALSE,"Jerry Bird",76168,0,1958,1958
"329",FALSE,FALSE,"Larry Bird",1449,12,1979,1991
"330",FALSE,FALSE,"Otis Birdsong",76170,11,1977,1988
"331",FALSE,FALSE,"Gale Bishop",76171,0,1948,1948
"332",TRUE,FALSE,"Goga Bitadze",1629048,1,2019,2020
"333",TRUE,FALSE,"Bismack Biyombo",202687,9,2011,2020
"334",TRUE,FALSE,"Nemanja Bjelica",202357,5,2015,2020
"335",FALSE,FALSE,"Uwe Blab",76172,4,1985,1989
"336",FALSE,FALSE,"Charlie Black",76173,3,1948,1951
"337",FALSE,FALSE,"Norman Black",76174,0,1980,1980
"338",FALSE,FALSE,"Tarik Black",204028,3,2014,2017
"339",FALSE,FALSE,"Tom Black",76175,0,1970,1970
"340",FALSE,FALSE,"Rolando Blackman",76176,12,1981,1993
"341",FALSE,FALSE,"Alex Blackwell",76180,0,1992,1992
"342",FALSE,FALSE,"Cory Blackwell",76177,0,1984,1984
"343",FALSE,FALSE,"James Blackwell",1806,0,1994,1994
"344",FALSE,FALSE,"Nate Blackwell",76179,0,1987,1987
"345",FALSE,FALSE,"DeJuan Blair",201971,6,2009,2015
"346",FALSE,FALSE,"Steve Blake",2581,12,2003,2015
"347",FALSE,FALSE,"Marqus Blakely",202392,0,2010,2010
"348",FALSE,FALSE,"Antonio Blakeney",1628469,1,2017,2018
"349",FALSE,FALSE,"Will Blalock",200807,0,2006,2006
"350",FALSE,FALSE,"George Blaney",76182,0,1961,1961
"351",FALSE,FALSE,"Lance Blanks",76183,2,1990,1992
"352",FALSE,FALSE,"Ricky Blanton",76184,0,1992,1992
"353",FALSE,FALSE,"Andray Blatche",101154,8,2005,2013
"354",FALSE,FALSE,"Mookie Blaylock",302,12,1989,2001
"355",TRUE,FALSE,"Eric Bledsoe",202339,10,2010,2020
"356",TRUE,TRUE,"Keljin Blevins",1629833,0,2020,2020
"357",FALSE,FALSE,"Leon Blevins",76186,0,1950,1950
"358",FALSE,FALSE,"John Block",76187,9,1966,1975
"359",FALSE,FALSE,"Mike Bloom",76188,1,1947,1948
"360",FALSE,FALSE,"Jaron Blossomgame",1628417,0,2018,2018
"361",FALSE,FALSE,"Corie Blount",916,10,1993,2003
"362",FALSE,FALSE,"Mark Blount",1548,8,2000,2008
"363",FALSE,FALSE,"Vander Blue",203505,4,2013,2017
"364",FALSE,FALSE,"Trevon Bluiett",1629129,0,2018,2018
"365",FALSE,FALSE,"Ray Blume",76189,0,1981,1981
"366",FALSE,FALSE,"Nelson Bobb",76190,3,1949,1952
"367",FALSE,FALSE,"Tony Bobbitt",2800,0,2004,2004
"368",FALSE,FALSE,"Arlen Bockhorn",76191,6,1958,1964
"369",FALSE,FALSE,"Tom Boerwinkle",76192,9,1968,1977
"370",FALSE,FALSE,"Keith Bogans",2586,10,2003,2013
"371",TRUE,FALSE,"Bogdan Bogdanovic",203992,3,2017,2020
"372",TRUE,FALSE,"Bojan Bogdanovic",202711,6,2014,2020
"373",FALSE,FALSE,"Muggsy Bogues",177,13,1987,2000
"374",FALSE,FALSE,"Andrew Bogut",101106,13,2005,2018
"375",FALSE,FALSE,"Etdrick Bohannon",1564,3,1997,2000
"376",TRUE,FALSE,"Bol Bol",1629626,1,2019,2020
"377",FALSE,FALSE,"Manute Bol",76195,9,1985,1994
"378",FALSE,FALSE,"Jonah Bolden",1628413,1,2018,2019
"379",FALSE,FALSE,"Marques Bolden",1629716,1,2019,2020
"380",FALSE,FALSE,"Bill Bolger",76196,0,1953,1953
"381",FALSE,FALSE,"Joel Bolomboy",1627762,1,2016,2017
"382",FALSE,FALSE,"Doug Bolstorff",76197,0,1957,1957
"383",FALSE,FALSE,"George H. Bon Salle",76203,0,1961,1961
"384",FALSE,FALSE,"Phil Bond",76198,0,1977,1977
"385",FALSE,FALSE,"Walter Bond",1603,2,1992,1994
"386",FALSE,FALSE,"Jordan Bone",1629648,1,2019,2020
"387",FALSE,FALSE,"Dexter Boney",1121,0,1996,1996
"388",TRUE,FALSE,"Isaac Bonga",1629067,2,2018,2020
"389",FALSE,FALSE,"Ron Bonham",76201,1,1964,1965
"390",FALSE,FALSE,"Anthony Bonner",41,12,1990,2002
"391",FALSE,FALSE,"Matt Bonner",2588,11,2004,2015
"392",TRUE,FALSE,"Devin Booker",1626164,5,2015,2020
"393",FALSE,FALSE,"Melvin Booker",511,1,1995,1996
"394",FALSE,FALSE,"Trevor Booker",202344,7,2010,2017
"395",FALSE,FALSE,"Josh Boone",200767,3,2006,2009
"396",FALSE,FALSE,"Ron Boone",76204,4,1976,1980
"397",FALSE,FALSE,"Calvin Booth",1916,9,1999,2008
"398",FALSE,FALSE,"Keith Booth",1522,1,1997,1998
"399",FALSE,FALSE,"Bob Boozer",76206,10,1960,1970
"400",FALSE,FALSE,"Carlos Boozer",2430,12,2002,2014
"401",FALSE,FALSE,"Curtis Borchardt",2414,2,2002,2004
"402",FALSE,FALSE,"Jake Bornheimer",76207,1,1948,1949
"403",FALSE,FALSE,"Lazaro Borrell",1953,0,1999,1999
"404",FALSE,FALSE,"Costic Borsavage",76209,0,1950,1950
"405",FALSE,FALSE,"Vince Boryla",76210,4,1949,1953
"406",FALSE,FALSE,"Chris Bosh",2547,13,2003,2016
"407",FALSE,FALSE,"Jim Bostic",76211,0,1977,1977
"408",FALSE,FALSE,"Lawrence Boston",76212,0,1979,1979
"409",FALSE,FALSE,"Tom Boswell",76213,8,1975,1983
"410",TRUE,FALSE,"Chris Boucher",1628449,3,2017,2020
"411",FALSE,FALSE,"Ruben Boumtje-Boumtje",2257,2,2001,2003
"412",FALSE,FALSE,"Don Boven",76214,3,1949,1952
"413",FALSE,FALSE,"Cal Bowdler",1898,2,1999,2001
"414",FALSE,FALSE,"Bruce Bowen",1477,12,1996,2008
"415",FALSE,FALSE,"Ryan Bowen",1763,10,1999,2009
"416",FALSE,FALSE,"Brian Bowen II",1628968,1,2019,2020
"417",FALSE,FALSE,"Anthony Bowie",194,9,1988,1997
"418",FALSE,FALSE,"Sam Bowie",76217,10,1984,1994
"419",FALSE,FALSE,"Ira Bowman",1085,2,1999,2001
"420",FALSE,FALSE,"Ky Bowman",1629065,0,2019,2019
"421",FALSE,FALSE,"Nate Bowman",76219,4,1966,1970
"422",FALSE,FALSE,"Donnie Boyce",671,1,1995,1996
"423",FALSE,FALSE,"Dennis Boyd",76221,0,1978,1978
"424",FALSE,FALSE,"Fred Boyd",76222,5,1972,1977
"425",FALSE,FALSE,"Ken Boyd",76223,0,1974,1974
"426",FALSE,FALSE,"Earl Boykins",1863,13,1998,2011
"427",FALSE,FALSE,"Harry Boykoff",76224,1,1949,1950
"428",FALSE,FALSE,"Winford Boynes",76225,2,1978,1980
"429",FALSE,FALSE,"Cedric Bozeman",200841,0,2006,2006
"430",FALSE,FALSE,"Steve Bracey",76226,2,1972,1974
"431",FALSE,FALSE,"Craig Brackins",202342,1,2010,2011
"432",FALSE,FALSE,"Gary Bradds",76227,1,1964,1965
"433",FALSE,FALSE,"Alex Bradley",76228,0,1981,1981
"434",FALSE,FALSE,"Alonzo Bradley",76229,2,1977,1979
"435",TRUE,FALSE,"Avery Bradley",202340,10,2010,2020
"436",FALSE,FALSE,"Bill Bradley",76233,9,1967,1976
"437",FALSE,FALSE,"Charles Bradley",76230,2,1981,1983
"438",FALSE,FALSE,"Dudley Bradley",76231,9,1979,1988
"439",FALSE,FALSE,"Joe Bradley",76232,0,1949,1949
"440",FALSE,FALSE,"Michael Bradley",2214,4,2001,2005
"441",FALSE,FALSE,"Shawn Bradley",762,11,1993,2004
"442",TRUE,FALSE,"Tony Bradley",1628396,3,2017,2020
"443",FALSE,FALSE,"Mark Bradtke",1361,0,1996,1996
"444",FALSE,FALSE,"Marques Bragg",66,0,1995,1995
"445",FALSE,FALSE,"Torraye Braggs",1765,1,2003,2004
"446",FALSE,FALSE,"A.J. Bramlett",1920,0,1999,1999
"447",FALSE,FALSE,"Adrian Branch",76237,3,1986,1989
"448",FALSE,FALSE,"Elton Brand",1882,16,1999,2015
"449",FALSE,FALSE,"Terrell Brandon",210,11,1991,2002
"450",FALSE,FALSE,"Bob Brannum",76238,5,1949,1954
"451",FALSE,FALSE,"Brad Branson",76239,1,1981,1982
"452",FALSE,FALSE,"Jesse Branson",76240,0,1965,1965
"453",TRUE,FALSE,"Jarrell Brantley",1629714,1,2019,2020
"454",FALSE,FALSE,"Jim Brasco",76241,0,1952,1952
"455",FALSE,FALSE,"Mike Bratz",76242,8,1977,1985
"456",FALSE,FALSE,"Carl Braun",76243,14,1947,1961
"457",TRUE,FALSE,"Ignas Brazdeikis",1629649,1,2019,2020
"458",FALSE,FALSE,"Tim Breaux",160,3,1994,1997
"459",FALSE,FALSE,"J.R. Bremer",2452,1,2002,2003
"460",FALSE,FALSE,"Pete Brennan",76245,0,1958,1958
"461",FALSE,FALSE,"Tom Brennan",76246,0,1954,1954
"462",FALSE,FALSE,"Randy Breuer",76247,10,1983,1993
"463",FALSE,FALSE,"Corey Brewer",201147,12,2007,2019
"464",FALSE,FALSE,"Jamison Brewer",2249,3,2001,2004
"465",FALSE,FALSE,"Jim Brewer",76248,8,1973,1981
"466",FALSE,FALSE,"Ron Brewer",76249,7,1978,1985
"467",FALSE,FALSE,"Ronnie Brewer",200758,7,2006,2013
"468",FALSE,FALSE,"Primoz Brezec",2056,8,2001,2009
"469",FALSE,FALSE,"Frank Brian",76250,6,1949,1955
"470",FALSE,FALSE,"Frank Brickowski",783,12,1984,1996
"471",FALSE,FALSE,"Junior Bridgeman",76252,11,1975,1986
"472",FALSE,FALSE,"Bill Bridges",76253,12,1962,1974
"473",TRUE,FALSE,"Mikal Bridges",1628969,2,2018,2020
"474",TRUE,FALSE,"Miles Bridges",1628970,2,2018,2020
"475",FALSE,FALSE,"Al Brightman",76254,0,1946,1946
"476",TRUE,TRUE,"Amida Brimah",1628578,0,2020,2020
"477",FALSE,FALSE,"Audley Brindley",76255,0,1946,1946
"478",FALSE,FALSE,"Isaiah Briscoe",1628515,0,2018,2018
"479",FALSE,FALSE,"John Brisker",76256,2,1972,1974
"480",TRUE,FALSE,"Oshae Brissett",1629052,1,2019,2020
"481",FALSE,FALSE,"Allan Bristow",76257,9,1973,1982
"482",FALSE,FALSE,"Tyrone Britt",76258,0,1967,1967
"483",FALSE,FALSE,"Wayman Britt",76259,0,1977,1977
"484",FALSE,FALSE,"Mike Brittain",76260,1,1985,1986
"485",FALSE,FALSE,"David Britton",76261,0,1980,1980
"486",FALSE,FALSE,"Jon Brockman",201972,2,2009,2011
"487",FALSE,FALSE,"Ryan Broekhoff",1629151,1,2018,2019
"488",FALSE,FALSE,"Jim Brogan",76262,1,1981,1982
"489",TRUE,FALSE,"Malcolm Brogdon",1627763,4,2016,2020
"490",FALSE,FALSE,"Gary Brokaw",76263,3,1974,1977
"491",FALSE,FALSE,"Price Brookfield",76264,1,1948,1949
"492",FALSE,FALSE,"Aaron Brooks",201166,10,2007,2017
"493",TRUE,TRUE,"Armoni Brooks",1629717,0,2020,2020
"494",TRUE,FALSE,"Dillon Brooks",1628415,3,2017,2020
"495",FALSE,FALSE,"Kevin Brooks",76265,2,1991,1993
"496",FALSE,FALSE,"MarShon Brooks",202705,7,2011,2018
"497",FALSE,FALSE,"Michael Brooks",76266,7,1980,1987
"498",FALSE,FALSE,"Scott Brooks",418,9,1988,1997
"499",FALSE,FALSE,"Andre Brown",2810,2,2006,2008
"500",FALSE,FALSE,"Anthony Brown",1626148,2,2015,2017
"501",FALSE,FALSE,"Bob Brown",76284,1,1948,1949
"502",FALSE,FALSE,"Bobby Brown",201628,9,2008,2017
"503",TRUE,FALSE,"Bruce Brown",1628971,2,2018,2020
"504",FALSE,FALSE,"Chucky Brown",359,12,1989,2001
"505",FALSE,FALSE,"Damone Brown",2245,3,2001,2004
"506",FALSE,FALSE,"Darrell Brown",76270,0,1948,1948
"507",FALSE,FALSE,"Dee Brown",244,11,1990,2001
"508",FALSE,FALSE,"Dee Brown",200793,2,2006,2008
"509",FALSE,FALSE,"Derrick Brown",201974,2,2009,2011
"510",FALSE,FALSE,"Devin Brown",2484,7,2002,2009
"511",FALSE,FALSE,"Ernest Brown",2081,2,2001,2003
"512",FALSE,FALSE,"Fred Brown",76272,12,1971,1983
"513",FALSE,FALSE,"George Brown",76273,0,1957,1957
"514",FALSE,FALSE,"Gerald Brown",1871,0,1998,1998
"515",FALSE,FALSE,"Harold Brown",76275,0,1946,1946
"516",FALSE,FALSE,"Jabari Brown",203913,0,2014,2014
"517",TRUE,FALSE,"Jaylen Brown",1627759,4,2016,2020
"518",FALSE,FALSE,"John Brown",76276,6,1973,1979
"519",FALSE,FALSE,"Kedrick Brown",2208,3,2001,2004
"520",FALSE,FALSE,"Kwame Brown",2198,11,2001,2012
"521",FALSE,FALSE,"Leon Brown",76278,0,1946,1946
"522",FALSE,FALSE,"Lewis Brown",76279,0,1980,1980
"523",FALSE,FALSE,"Lorenzo Brown",203485,5,2013,2018
"524",FALSE,FALSE,"Marcus Brown",992,3,1996,1999
"525",FALSE,FALSE,"Markel Brown",203900,3,2014,2017
"526",FALSE,FALSE,"Mike Brown",1479,11,1986,1997
"527",TRUE,FALSE,"Moses Brown",1629650,1,2019,2020
"528",FALSE,FALSE,"Myron Brown",76277,0,1991,1991
"529",FALSE,FALSE,"P.J. Brown",136,14,1993,2007
"530",FALSE,FALSE,"Randy Brown",753,11,1991,2002
"531",FALSE,FALSE,"Raymond Brown",76282,0,1989,1989
"532",FALSE,FALSE,"Rickey Brown",76283,4,1980,1984
"533",FALSE,FALSE,"Roger Brown",76286,7,1972,1979
"534",FALSE,FALSE,"Shannon Brown",200769,8,2006,2014
"535",FALSE,FALSE,"Stan Brown",76285,4,1947,1951
"536",TRUE,FALSE,"Sterling Brown",1628425,3,2017,2020
"537",FALSE,FALSE,"Tierre Brown",2357,3,2001,2004
"538",FALSE,FALSE,"Tony Brown",76268,7,1984,1991
"539",TRUE,FALSE,"Charlie Brown Jr.",1629718,1,2019,2020
"540",TRUE,FALSE,"Troy Brown Jr.",1628972,2,2018,2020
"541",FALSE,FALSE,"Jim Browne",76287,1,1948,1949
"542",FALSE,FALSE,"Stanley Brundy",76288,0,1989,1989
"543",TRUE,FALSE,"Jalen Brunson",1628973,2,2018,2020
"544",FALSE,FALSE,"Rick Brunson",1594,8,1997,2005
"545",FALSE,FALSE,"Nicolas Brussino",1627852,1,2016,2017
"546",TRUE,TRUE,"Elijah Bryant",1629091,0,2020,2020
"547",FALSE,FALSE,"Emmette Bryant",76289,7,1964,1971
"548",FALSE,FALSE,"Joe Bryant",76290,7,1975,1982
"549",FALSE,FALSE,"Kobe Bryant",977,19,1996,2015
"550",FALSE,FALSE,"Mark Bryant",95,14,1988,2002
"551",TRUE,FALSE,"Thomas Bryant",1628418,3,2017,2020
"552",FALSE,FALSE,"Wallace Bryant",76291,2,1983,1985
"553",FALSE,FALSE,"Torgeir Bryn",76292,0,1989,1989
"554",FALSE,FALSE,"Joe Buckhalter",76293,1,1961,1962
"555",FALSE,FALSE,"Steve Bucknall",76294,0,1989,1989
"556",FALSE,FALSE,"Cleveland Buckner",76295,1,1961,1962
"557",FALSE,FALSE,"Greg Buckner",1761,9,1999,2008
"558",FALSE,FALSE,"Quinn Buckner",76296,9,1976,1985
"559",FALSE,FALSE,"Dave Budd",76297,4,1960,1964
"560",FALSE,FALSE,"Chase Budinger",201978,6,2009,2015
"561",FALSE,FALSE,"Walter Budko",76298,3,1948,1951
"562",FALSE,FALSE,"Jud Buechler",146,11,1990,2001
"563",FALSE,FALSE,"Rodney Buford",1934,5,1999,2004
"564",FALSE,FALSE,"Matt Bullard",672,12,1990,2002
"565",TRUE,FALSE,"Reggie Bullock",203493,7,2013,2020
"566",FALSE,FALSE,"Greg Bunch",76300,0,1978,1978
"567",FALSE,FALSE,"Dick Bunt",76301,0,1952,1952
"568",FALSE,FALSE,"Bill Buntin",76302,0,1965,1965
"569",FALSE,FALSE,"Luther Burden",76303,1,1976,1977
"570",FALSE,FALSE,"Pat Burke",2469,4,2002,2006
"571",TRUE,FALSE,"Trey Burke",203504,7,2013,2020
"572",FALSE,FALSE,"Roger Burkman",76304,0,1981,1981
"573",TRUE,FALSE,"Alec Burks",202692,9,2011,2020
"574",FALSE,FALSE,"Antonio Burks",2766,1,2004,2005
"575",FALSE,FALSE,"Kevin Burleson",101207,0,2005,2005
"576",FALSE,FALSE,"Tom Burleson",76305,6,1974,1980
"577",FALSE,FALSE,"Jack Burmaster",76306,0,1949,1949
"578",FALSE,FALSE,"David Burns",76307,0,1981,1981
"579",FALSE,FALSE,"Evers Burns",76308,0,1993,1993
"580",FALSE,FALSE,"Jim Burns",76309,0,1967,1967
"581",FALSE,FALSE,"Scott Burrell",197,7,1993,2000
"582",FALSE,FALSE,"Art Burris",76311,1,1950,1951
"583",FALSE,FALSE,"Junior Burrough",675,0,1995,1995
"584",FALSE,FALSE,"Bob Burrow",76313,1,1956,1957
"585",FALSE,FALSE,"Deonte Burton",1629126,1,2018,2019
"586",FALSE,FALSE,"Ed Burton",76314,3,1961,1964
"587",FALSE,FALSE,"Willie Burton",416,8,1990,1998
"588",FALSE,FALSE,"Steve Burtt",76316,8,1984,1992
"589",FALSE,FALSE,"Don Buse",76317,8,1976,1984
"590",FALSE,FALSE,"Brian Butch",202221,0,2009,2009
"591",FALSE,FALSE,"Donnie Butcher",76318,4,1961,1965
"592",FALSE,FALSE,"Al Butler",76319,3,1961,1964
"593",FALSE,FALSE,"Caron Butler",2406,13,2002,2015
"594",FALSE,FALSE,"Da'Sean Butler",202364,0,2010,2010
"595",FALSE,FALSE,"Greg Butler",76320,2,1988,1990
"596",FALSE,FALSE,"Jackie Butler",2866,2,2004,2006
"597",TRUE,FALSE,"Jimmy Butler",202710,9,2011,2020
"598",FALSE,FALSE,"Mitchell Butler",348,10,1993,2003
"599",FALSE,FALSE,"Rasual Butler",2446,13,2002,2015
"600",FALSE,FALSE,"Dwight Buycks",202779,4,2013,2017
"601",FALSE,FALSE,"Derrick Byars",201182,0,2011,2011
"602",FALSE,FALSE,"Andrew Bynum",101115,8,2005,2013
"603",FALSE,FALSE,"Will Bynum",101198,9,2005,2014
"604",FALSE,FALSE,"Marty Byrnes",76321,4,1978,1982
"605",FALSE,FALSE,"Tommy Byrnes",76322,4,1946,1950
"606",FALSE,FALSE,"Mike Bytzura",76323,0,1946,1946
"607",FALSE,FALSE,"Zarko Cabarkapa",2560,3,2003,2006
"608",FALSE,FALSE,"Barney Cable",76324,5,1958,1963
"609",FALSE,FALSE,"Bruno Caboclo",203998,6,2014,2020
"610",TRUE,FALSE,"Devontae Cacok",1629719,1,2019,2020
"611",FALSE,FALSE,"Jason Caffey",679,7,1995,2002
"612",FALSE,FALSE,"Michael Cage",262,15,1984,1999
"613",FALSE,FALSE,"Gerry Calabrese",76326,1,1950,1951
"614",FALSE,FALSE,"Nick Calathes",201979,1,2013,2014
"615",FALSE,FALSE,"Jose Calderon",101181,13,2005,2018
"616",FALSE,FALSE,"Adrian Caldwell",154,8,1989,1997
"617",FALSE,FALSE,"Jim Caldwell",76328,0,1967,1967
"618",FALSE,FALSE,"Joe Caldwell",76329,5,1964,1969
"619",TRUE,FALSE,"Kentavious Caldwell-Pope",203484,7,2013,2020
"620",FALSE,FALSE,"Bill Calhoun",76331,6,1948,1954
"621",FALSE,FALSE,"Corky Calhoun",76330,7,1972,1979
"622",FALSE,FALSE,"Demetrius Calip",76332,0,1991,1991
"623",FALSE,FALSE,"Tom Callahan",76333,0,1946,1946
"624",FALSE,FALSE,"Rick Calloway",76334,0,1990,1990
"625",FALSE,FALSE,"Ernie Calverley",76335,2,1946,1948
"626",FALSE,FALSE,"Mack Calvin",76336,4,1976,1980
"627",FALSE,FALSE,"Dexter Cambridge",76337,0,1992,1992
"628",FALSE,FALSE,"Marcus Camby",948,16,1996,2012
"629",TRUE,TRUE,"Facundo Campazzo",1630267,0,2020,2020
"630",FALSE,FALSE,"Elden Campbell",922,14,1990,2004
"631",FALSE,FALSE,"Tony Campbell",76338,10,1984,1994
"632",FALSE,FALSE,"Isaiah Canaan",203477,5,2013,2018
"633",TRUE,FALSE,"Vlatko Cancar",1628427,1,2019,2020
"634",FALSE,TRUE,"Devin Cannady",1629962,0,2020,2020
"635",FALSE,FALSE,"Larry Cannon",76339,0,1973,1973
"636",TRUE,FALSE,"Clint Capela",203991,6,2014,2020
"637",FALSE,FALSE,"Derrick Caracter",202382,0,2010,2010
"638",FALSE,FALSE,"Brian Cardinal",2073,11,2000,2011
"639",TRUE,TRUE,"Vernon Carey Jr.",1630176,0,2020,2020
"640",FALSE,FALSE,"Howie Carl",76340,0,1961,1961
"641",FALSE,FALSE,"Chet Carlisle",76341,0,1946,1946
"642",FALSE,FALSE,"Geno Carlisle",2367,0,2004,2004
"643",FALSE,FALSE,"Rick Carlisle",76342,5,1984,1989
"644",FALSE,FALSE,"Al Carlson",76343,0,1975,1975
"645",FALSE,FALSE,"Don Carlson",76344,4,1946,1950
"646",FALSE,FALSE,"Bob Carney",76345,0,1954,1954
"647",FALSE,FALSE,"Rodney Carney",200760,4,2006,2010
"648",FALSE,FALSE,"Bob Carpenter",76346,1,1949,1950
"649",FALSE,FALSE,"Antoine Carr",156,15,1984,1999
"650",FALSE,FALSE,"Austin Carr",76348,9,1971,1980
"651",FALSE,FALSE,"Chris Carr",713,5,1995,2000
"652",FALSE,FALSE,"Cory Carr",1757,0,1998,1998
"653",FALSE,FALSE,"Kenny Carr",76350,9,1977,1986
"654",FALSE,FALSE,"M.L. Carr",76351,8,1976,1984
"655",FALSE,FALSE,"Bob Carrington",76352,2,1977,1979
"656",FALSE,FALSE,"DeMarre Carroll",201960,10,2009,2019
"657",FALSE,FALSE,"Joe Barry Carroll",76353,10,1980,1990
"658",FALSE,FALSE,"Matt Carroll",2679,9,2003,2012
"659",FALSE,FALSE,"Jimmy Carruth",1131,0,1996,1996
"660",FALSE,FALSE,"Anthony Carter",1853,12,1999,2011
"661",FALSE,FALSE,"Butch Carter",76355,5,1980,1985
"662",FALSE,FALSE,"Fred Carter",76356,7,1969,1976
"663",FALSE,FALSE,"George Carter",76357,0,1967,1967
"664",FALSE,FALSE,"Howard Carter",76358,1,1983,1984
"665",FALSE,FALSE,"Jake Carter",76359,0,1949,1949
"666",TRUE,FALSE,"Jevon Carter",1628975,2,2018,2020
"667",FALSE,FALSE,"Maurice Carter",2466,1,2002,2003
"668",FALSE,FALSE,"Reggie Carter",76360,1,1980,1981
"669",FALSE,FALSE,"Ron Carter",76361,1,1978,1979
"670",FALSE,FALSE,"Vince Carter",1713,21,1998,2019
"671",TRUE,FALSE,"Wendell Carter Jr.",1628976,2,2018,2020
"672",TRUE,FALSE,"Michael Carter-Williams",203487,7,2013,2020
"673",FALSE,FALSE,"Bill Cartwright",76362,15,1979,1994
"674",FALSE,FALSE,"Jay Carty",76363,0,1968,1968
"675",TRUE,FALSE,"Alex Caruso",1627936,3,2017,2020
"676",FALSE,FALSE,"Cornelius Cash",76364,0,1976,1976
"677",FALSE,FALSE,"Sam Cassell",208,14,1993,2007
"678",FALSE,FALSE,"Omri Casspi",201956,9,2009,2018
"679",FALSE,FALSE,"Harvey Catchings",76365,10,1974,1984
"680",FALSE,FALSE,"Terry Catledge",767,7,1985,1992
"681",FALSE,FALSE,"Sid Catlett",76367,0,1971,1971
"682",FALSE,FALSE,"Kelvin Cato",1509,9,1997,2006
"683",FALSE,FALSE,"Bobby Cattage",76368,4,1981,1985
"684",TRUE,FALSE,"Willie Cauley-Stein",1626161,5,2015,2020
"685",FALSE,FALSE,"Troy Caupain",1628505,0,2018,2018
"686",FALSE,FALSE,"Duane Causwell",190,12,1990,2002
"687",FALSE,FALSE,"Tyler Cavanaugh",1628463,1,2017,2018
"688",FALSE,FALSE,"Ron Cavenall",76370,4,1984,1988
"689",FALSE,FALSE,"Cedric Ceballos",76,10,1990,2000
"690",FALSE,FALSE,"John Celestand",1911,3,1999,2002
"691",FALSE,FALSE,"Al Cervi",76373,3,1949,1952
"692",FALSE,FALSE,"Lionel Chalmers",2763,0,2004,2004
"693",FALSE,FALSE,"Mario Chalmers",201596,9,2008,2017
"694",FALSE,FALSE,"Bill Chamberlain",76374,0,1973,1973
"695",FALSE,FALSE,"Wilt Chamberlain",76375,13,1959,1972
"696",FALSE,FALSE,"Jerry Chambers",76376,5,1966,1971
"697",FALSE,FALSE,"Tom Chambers",1472,16,1981,1997
"698",FALSE,FALSE,"Mike Champion",76378,0,1988,1988
"699",FALSE,FALSE,"Tyson Chandler",2199,18,2001,2019
"700",FALSE,FALSE,"Wilson Chandler",201163,12,2007,2019
"701",FALSE,FALSE,"Don Chaney",76379,11,1968,1979
"702",FALSE,FALSE,"John Chaney",76380,0,1949,1949
"703",FALSE,FALSE,"Rex Chapman",364,11,1988,1999
"704",FALSE,FALSE,"Len Chappell",76382,8,1962,1970
"705",FALSE,FALSE,"Ken Charles",76383,4,1973,1977
"706",FALSE,FALSE,"Lorenzo Charles",76384,0,1985,1985
"707",FALSE,FALSE,"Joe Chealey",1629147,1,2018,2019
"708",FALSE,FALSE,"Calbert Cheaney",384,12,1993,2005
"709",FALSE,FALSE,"Zylan Cheatham",1629597,0,2019,2019
"710",FALSE,FALSE,"Maurice Cheeks",76385,14,1978,1992
"711",FALSE,FALSE,"Phil Chenier",76386,9,1971,1980
"712",FALSE,FALSE,"Will Cherry",203805,0,2014,2014
"713",FALSE,FALSE,"Derrick Chievous",76387,2,1988,1990
"714",FALSE,FALSE,"Pete Chilcutt",432,8,1991,1999
"715",FALSE,FALSE,"Josh Childress",2735,9,2004,2013
"716",FALSE,FALSE,"Randolph Childress",719,1,1995,1996
"717",FALSE,FALSE,"Chris Childs",164,8,1994,2002
"718",TRUE,FALSE,"Chris Chiozza",1629185,2,2018,2020
"719",FALSE,FALSE,"Leroy Chollet",76391,1,1949,1950
"720",FALSE,FALSE,"Jim Chones",76392,7,1974,1981
"721",FALSE,FALSE,"Marquese Chriss",1627737,4,2016,2020
"722",FALSE,FALSE,"Fred Christ",76393,0,1954,1954
"723",FALSE,FALSE,"Cal Christensen",76394,4,1950,1954
"724",FALSE,FALSE,"Bob Christian",76395,3,1970,1973
"725",FALSE,FALSE,"Doug Christie",57,14,1992,2006
"726",FALSE,FALSE,"Dionte Christmas",202091,0,2013,2013
"727",FALSE,FALSE,"Rakeem Christmas",1626176,1,2015,2016
"728",FALSE,FALSE,"Semaj Christon",203902,0,2016,2016
"729",FALSE,FALSE,"Patrick Christopher",203565,0,2014,2014
"730",FALSE,FALSE,"Robert Churchwell",928,0,1995,1995
"731",FALSE,FALSE,"Archie Clark",76397,9,1966,1975
"732",FALSE,FALSE,"Carlos Clark",76398,1,1983,1984
"733",FALSE,FALSE,"Earl Clark",201947,5,2009,2014
"734",TRUE,FALSE,"Gary Clark",1629109,2,2018,2020
"735",FALSE,FALSE,"Ian Clark",203546,5,2013,2018
"736",FALSE,FALSE,"Keon Clark",1721,5,1998,2003
"737",TRUE,FALSE,"Brandon Clarke",1629634,1,2019,2020
"738",FALSE,FALSE,"Coty Clarke",1626262,0,2015,2015
"739",TRUE,FALSE,"Jordan Clarkson",203903,6,2014,2020
"740",FALSE,FALSE,"Gian Clavell",1628492,0,2017,2017
"741",FALSE,FALSE,"Victor Claver",201964,2,2012,2014
"742",FALSE,FALSE,"Charles Claxton",1127,0,1995,1995
"743",TRUE,FALSE,"Nicolas Claxton",1629651,1,2019,2020
"744",FALSE,FALSE,"Speedy Claxton",2049,7,2001,2008
"745",FALSE,FALSE,"Jim Cleamons",76402,8,1971,1979
"746",FALSE,FALSE,"Mateen Cleaves",2043,5,2000,2005
"747",FALSE,FALSE,"John Clemens",76403,10,1965,1975
"748",FALSE,FALSE,"Chris Clemons",1629598,0,2019,2019
"749",FALSE,FALSE,"Antonius Cleveland",1628499,2,2017,2019
"750",FALSE,FALSE,"Nat Clifton",76404,7,1950,1957
"751",FALSE,FALSE,"Bill Closs",76406,2,1949,1951
"752",FALSE,FALSE,"Keith Closs",1569,3,1997,2000
"753",FALSE,FALSE,"Paul Cloyd",76407,0,1949,1949
"754",FALSE,FALSE,"Marion Cluggish",76408,0,1946,1946
"755",FALSE,FALSE,"Ben Clyde",76409,0,1974,1974
"756",TRUE,FALSE,"Amir Coffey",1629599,1,2019,2020
"757",FALSE,FALSE,"Richard Coffey",76410,0,1990,1990
"758",FALSE,FALSE,"Fred Cofield",76411,1,1985,1986
"759",FALSE,FALSE,"John Coker",715,5,1995,2000
"760",FALSE,FALSE,"Norris Cole",202708,5,2011,2016
"761",FALSE,FALSE,"Ben Coleman",76412,7,1986,1993
"762",FALSE,FALSE,"Derrick Coleman",934,14,1990,2004
"763",FALSE,FALSE,"E.C. Coleman",76413,5,1973,1978
"764",FALSE,FALSE,"Jack Coleman",76414,8,1949,1957
"765",FALSE,FALSE,"Norris Coleman",76415,0,1987,1987
"766",FALSE,FALSE,"Bimbo Coles",902,13,1990,2003
"767",FALSE,FALSE,"Jason Collier",2044,4,2000,2004
"768",FALSE,FALSE,"Art Collins",76416,0,1980,1980
"769",FALSE,FALSE,"Don Collins",76418,6,1980,1986
"770",FALSE,FALSE,"Doug Collins",76421,7,1973,1980
"771",FALSE,FALSE,"James Collins",1530,0,1997,1997
"772",FALSE,FALSE,"Jarron Collins",2260,9,2001,2010
"773",FALSE,FALSE,"Jason Collins",2215,12,2001,2013
"774",FALSE,FALSE,"Jimmy Collins",76419,1,1970,1971
"775",TRUE,FALSE,"John Collins",1628381,3,2017,2020
"776",FALSE,FALSE,"Mardy Collins",200776,3,2006,2009
"777",FALSE,FALSE,"Sherron Collins",202395,0,2010,2010
"778",TRUE,FALSE,"Zach Collins",1628380,3,2017,2020
"779",FALSE,FALSE,"Kyle Collinsworth",1627858,0,2017,2017
"780",FALSE,FALSE,"Darren Collison",201954,9,2009,2018
"781",FALSE,FALSE,"Nick Collison",2555,14,2003,2017
"782",FALSE,FALSE,"Joe Colone",76422,0,1948,1948
"783",FALSE,FALSE,"Bonzie Colson",1629045,0,2018,2018
"784",FALSE,FALSE,"Sean Colson",2173,2,2000,2002
"785",FALSE,FALSE,"Steve Colter",306,10,1984,1994
"786",FALSE,FALSE,"Leroy Combs",76425,0,1983,1983
"787",FALSE,FALSE,"Dallas Comegys",76426,1,1987,1988
"788",FALSE,FALSE,"Larry Comley",76427,0,1963,1963
"789",FALSE,FALSE,"Gene Conley",76428,11,1952,1963
"790",TRUE,FALSE,"Mike Conley",201144,13,2007,2020
"791",FALSE,FALSE,"Ed Conlin",76429,6,1955,1961
"792",FALSE,FALSE,"Marty Conlon",55,8,1991,1999
"793",TRUE,FALSE,"Pat Connaughton",1626192,5,2015,2020
"794",FALSE,FALSE,"Lester Conner",76431,12,1982,1994
"795",FALSE,FALSE,"Chuck Connors",76432,1,1946,1947
"796",FALSE,FALSE,"Will Conroy",101215,6,2006,2012
"797",FALSE,FALSE,"Anthony Cook",76433,5,1990,1995
"798",FALSE,FALSE,"Bert Cook",76434,0,1954,1954
"799",FALSE,FALSE,"Bobby Cook",76438,0,1949,1949
"800",FALSE,FALSE,"Brian Cook",2567,8,2003,2011
"801",FALSE,FALSE,"Daequan Cook",201161,5,2007,2012
"802",FALSE,FALSE,"Darwin Cook",76435,8,1980,1988
"803",FALSE,FALSE,"Jeff Cook",76436,8,1979,1987
"804",FALSE,FALSE,"Norm Cook",76437,1,1976,1977
"805",FALSE,FALSE,"Omar Cook",2241,3,2001,2004
"806",FALSE,FALSE,"Quinn Cook",1626188,4,2016,2020
"807",TRUE,FALSE,"Tyler Cook",1629076,1,2019,2020
"808",FALSE,FALSE,"Charles Cooke",1628429,0,2017,2017
"809",FALSE,FALSE,"David Cooke",76439,0,1985,1985
"810",FALSE,FALSE,"Joe Cooke",76440,0,1970,1970
"811",FALSE,FALSE,"Jack Cooley",204022,3,2014,2017
"812",FALSE,FALSE,"Chuck Cooper",76442,5,1950,1955
"813",FALSE,FALSE,"Duane Cooper",1030,1,1992,1993
"814",FALSE,FALSE,"Joe Cooper",76443,3,1981,1984
"815",FALSE,FALSE,"Michael Cooper",76444,11,1978,1989
"816",FALSE,FALSE,"Wayne Cooper",76441,13,1978,1991
"817",FALSE,FALSE,"Tom Copa",76446,0,1991,1991
"818",FALSE,FALSE,"Chris Copeland",203142,3,2012,2015
"819",FALSE,FALSE,"Hollis Copeland",76447,2,1979,1981
"820",FALSE,FALSE,"Lanard Copeland",76448,2,1989,1991
"821",FALSE,FALSE,"Tyrone Corbin",895,15,1985,2000
"822",FALSE,FALSE,"Chris Corchiani",76450,2,1991,1993
"823",FALSE,FALSE,"Ken Corley",76451,0,1946,1946
"824",FALSE,FALSE,"Ray Corley",76452,3,1949,1952
"825",FALSE,FALSE,"Dave Corzine",76453,12,1978,1990
"826",FALSE,FALSE,"Larry Costello",76454,13,1954,1967
"827",FALSE,FALSE,"Matt Costello",1627856,0,2017,2017
"828",FALSE,FALSE,"Bryce Cotton",203955,1,2014,2015
"829",FALSE,FALSE,"Jack Cotton",76456,0,1949,1949
"830",FALSE,FALSE,"James Cotton",1526,1,1997,1998
"831",FALSE,FALSE,"John Coughran",76457,0,1979,1979
"832",FALSE,FALSE,"Mel Counts",76458,11,1964,1975
"833",FALSE,FALSE,"Steve Courtin",76459,0,1964,1964
"834",FALSE,FALSE,"Joe Courtney",1432,4,1992,1996
"835",FALSE,FALSE,"Marcus Cousin",202408,0,2010,2010
"836",TRUE,FALSE,"DeMarcus Cousins",202326,10,2010,2020
"837",FALSE,FALSE,"Bob Cousy",600003,19,1950,1969
"838",TRUE,FALSE,"Robert Covington",203496,7,2013,2020
"839",FALSE,FALSE,"Dave Cowens",76462,12,1970,1982
"840",FALSE,FALSE,"John Cox",76463,0,1982,1982
"841",FALSE,FALSE,"Johnny Cox",76464,0,1962,1962
"842",FALSE,FALSE,"Wesley Cox",76465,1,1977,1978
"843",FALSE,FALSE,"Allen Crabbe",203459,6,2013,2019
"844",TRUE,FALSE,"Torrey Craig",1628470,3,2017,2020
"845",FALSE,FALSE,"Chris Crawford",1544,6,1997,2003
"846",FALSE,FALSE,"Freddie Crawford",76466,4,1966,1970
"847",FALSE,FALSE,"Jamal Crawford",2037,19,2000,2019
"848",FALSE,FALSE,"Joe Crawford",201621,0,2008,2008
"849",FALSE,FALSE,"Jordan Crawford",202348,7,2010,2017
"850",FALSE,FALSE,"Mitchell Creek",1628249,0,2018,2018
"851",FALSE,FALSE,"Jim Creighton",76468,0,1975,1975
"852",FALSE,FALSE,"Ron Crevier",76469,0,1985,1985
"853",FALSE,FALSE,"Hal Crisler",76470,0,1946,1946
"854",FALSE,FALSE,"Joe Crispin",2343,0,2001,2001
"855",FALSE,FALSE,"Charlie Criss",76471,7,1977,1984
"856",FALSE,FALSE,"Winston Crite",76472,1,1987,1988
"857",FALSE,FALSE,"Javaris Crittenton",201159,2,2007,2009
"858",FALSE,FALSE,"Dillard Crocker",76473,4,1948,1952
"859",FALSE,FALSE,"Jeffrey Crompton",76474,5,1978,1983
"860",FALSE,FALSE,"Terry Crosby",76475,0,1979,1979
"861",FALSE,FALSE,"Austin Croshere",1506,11,1997,2008
"862",FALSE,FALSE,"Jeff Cross",76476,0,1985,1985
"863",FALSE,FALSE,"Pete Cross",76477,2,1970,1972
"864",FALSE,FALSE,"Russell Cross",76478,0,1983,1983
"865",FALSE,FALSE,"Francis Crossin",76479,2,1947,1949
"866",FALSE,FALSE,"John Crotty",180,10,1992,2002
"867",FALSE,FALSE,"Mark Crow",76481,0,1977,1977
"868",FALSE,FALSE,"Corey Crowder",76482,3,1991,1994
"869",TRUE,FALSE,"Jae Crowder",203109,8,2012,2020
"870",TRUE,FALSE,"Jarrett Culver",1629633,1,2019,2020
"871",FALSE,FALSE,"Pat Cummings",76483,11,1979,1990
"872",FALSE,FALSE,"Terry Cummings",187,17,1982,1999
"873",FALSE,FALSE,"Vonteego Cummings",1907,3,1999,2002
"874",FALSE,FALSE,"Billy Cunningham",76487,10,1965,1975
"875",FALSE,FALSE,"Dante Cunningham",201967,9,2009,2018
"876",FALSE,FALSE,"Dick Cunningham",76485,6,1968,1974
"877",FALSE,FALSE,"Jared Cunningham",203099,3,2012,2015
"878",FALSE,FALSE,"William Cunningham",1061,1,1997,1998
"879",FALSE,FALSE,"Radisav Curcic",76488,0,1992,1992
"880",FALSE,FALSE,"Armand Cure",76489,0,1946,1946
"881",FALSE,FALSE,"Earl Cureton",940,16,1980,1996
"882",FALSE,FALSE,"Bill Curley",223,6,1994,2000
"883",FALSE,FALSE,"Fran Curran",76492,1,1948,1949
"884",FALSE,FALSE,"Dell Curry",209,15,1986,2001
"885",FALSE,FALSE,"Eddy Curry",2201,11,2001,2012
"886",FALSE,FALSE,"JamesOn Curry",201191,2,2007,2009
"887",FALSE,FALSE,"Michael Curry",688,11,1993,2004
"888",TRUE,FALSE,"Seth Curry",203552,7,2013,2020
"889",TRUE,FALSE,"Stephen Curry",201939,11,2009,2020
"890",FALSE,FALSE,"Rastko Cvetkovic",687,0,1995,1995
"891",FALSE,FALSE,"Mike D'Antoni",76505,3,1973,1976
"892",FALSE,FALSE,"Ed Dahler",76496,0,1951,1951
"893",FALSE,FALSE,"Quintin Dailey",76497,9,1982,1991
"894",FALSE,FALSE,"Samuel Dalembert",2223,13,2001,2014
"895",FALSE,FALSE,"Howie Dallmar",76498,2,1946,1948
"896",FALSE,FALSE,"Erick Dampier",956,15,1996,2011
"897",FALSE,FALSE,"Lou Dampier",76499,2,1976,1978
"898",FALSE,FALSE,"Bob Dandridge",76500,12,1969,1981
"899",FALSE,FALSE,"Antonio Daniels",1498,13,1997,2010
"900",FALSE,FALSE,"Erik Daniels",2845,0,2004,2004
"901",FALSE,FALSE,"Lloyd Daniels",1380,5,1992,1997
"902",FALSE,FALSE,"Marquis Daniels",2605,9,2003,2012
"903",FALSE,FALSE,"Mel Daniels",76502,0,1976,1976
"904",FALSE,FALSE,"Troy Daniels",203584,6,2013,2019
"905",FALSE,FALSE,"Sasha Danilovic",390,1,1995,1996
"906",FALSE,FALSE,"Adrian Dantley",76504,14,1976,1990
"907",FALSE,FALSE,"Henry Darcey",76506,0,1952,1952
"908",FALSE,FALSE,"Jimmy Darden",76507,0,1949,1949
"909",FALSE,FALSE,"Yinka Dare",212,3,1994,1997
"910",FALSE,FALSE,"Jesse Dark",76509,0,1974,1974
"911",TRUE,TRUE,"Nate Darling",1630268,0,2020,2020
"912",FALSE,FALSE,"Jimmy Darrow",76511,0,1961,1961
"913",FALSE,FALSE,"Gigi Datome",203540,1,2013,2014
"914",FALSE,FALSE,"Brad Daugherty",921,7,1986,1993
"915",FALSE,FALSE,"Kornel David",1600,2,1998,2000
"916",FALSE,FALSE,"Jermareo Davidson",201176,1,2007,2008
"917",FALSE,FALSE,"Bob Davies",76514,6,1948,1954
"918",FALSE,FALSE,"Brandon Davies",203561,1,2013,2014
"919",TRUE,FALSE,"Anthony Davis",203076,8,2012,2020
"920",FALSE,FALSE,"Antonio Davis",213,12,1993,2005
"921",FALSE,FALSE,"Aubrey Davis",76515,0,1946,1946
"922",FALSE,FALSE,"Baron Davis",1884,12,1999,2011
"923",FALSE,FALSE,"Ben Davis",989,3,1996,1999
"924",FALSE,FALSE,"Bill Davis",76538,0,1946,1946
"925",FALSE,FALSE,"Bob Davis",76533,0,1972,1972
"926",FALSE,FALSE,"Brad Davis",76516,14,1977,1991
"927",FALSE,FALSE,"Brian Davis",76517,0,1993,1993
"928",FALSE,FALSE,"Charlie Davis",76518,8,1981,1989
"929",FALSE,FALSE,"Charlie Davis",76519,2,1971,1973
"930",FALSE,FALSE,"Dale Davis",905,15,1991,2006
"931",FALSE,FALSE,"Deyonta Davis",1627738,2,2016,2018
"932",FALSE,FALSE,"Double D Davis",76521,4,1972,1976
"933",TRUE,FALSE,"Ed Davis",202334,10,2010,2020
"934",FALSE,FALSE,"Edward Davis",76522,4,1972,1976
"935",FALSE,FALSE,"Emanual Davis",1023,6,1996,2002
"936",FALSE,FALSE,"Glen Davis",201175,7,2007,2014
"937",FALSE,FALSE,"Harry Davis",76523,1,1978,1979
"938",FALSE,FALSE,"Hubert Davis",93,11,1992,2003
"939",FALSE,FALSE,"James Davis",76524,0,1955,1955
"940",FALSE,FALSE,"Jim Davis",76525,7,1967,1974
"941",FALSE,FALSE,"Johnny Davis",76526,9,1976,1985
"942",FALSE,FALSE,"Josh Davis",2668,8,2003,2011
"943",FALSE,FALSE,"Mark Davis",707,4,1995,1999
"944",FALSE,FALSE,"Mark Davis",76528,0,1988,1988
"945",FALSE,FALSE,"Mel Davis",76529,3,1973,1976
"946",FALSE,FALSE,"Michael Davis",76530,0,1982,1982
"947",FALSE,FALSE,"Mike Davis",76531,3,1969,1972
"948",FALSE,FALSE,"Monti Davis",76520,0,1980,1980
"949",FALSE,FALSE,"Paul Davis",200781,3,2006,2009
"950",FALSE,FALSE,"Ralph Davis",76532,1,1960,1961
"951",FALSE,FALSE,"Ricky Davis",1729,11,1998,2009
"952",FALSE,FALSE,"Ron Davis",76534,5,1976,1981
"953",TRUE,FALSE,"Terence Davis",1629056,1,2019,2020
"954",FALSE,FALSE,"Terry Davis",426,11,1989,2000
"955",FALSE,FALSE,"Tyler Davis",1629093,0,2018,2018
"956",FALSE,FALSE,"Walt Davis",76536,4,1953,1957
"957",FALSE,FALSE,"Walter Davis",1453,14,1977,1991
"958",FALSE,FALSE,"Andre Dawkins",203958,0,2014,2014
"959",FALSE,FALSE,"Darryl Dawkins",76539,13,1975,1988
"960",FALSE,FALSE,"Johnny Dawkins",1008,8,1986,1994
"961",FALSE,FALSE,"Paul Dawkins",76541,0,1979,1979
"962",FALSE,FALSE,"Branden Dawson",1626183,0,2015,2015
"963",FALSE,FALSE,"Eric Dawson",201286,0,2011,2011
"964",FALSE,FALSE,"Tony Dawson",76542,4,1990,1994
"965",FALSE,FALSE,"Todd Day",103,8,1992,2000
"966",FALSE,FALSE,"Austin Daye",201948,5,2009,2014
"967",FALSE,FALSE,"Darren Daye",76543,4,1983,1987
"968",FALSE,FALSE,"Nando De Colo",201986,1,2012,2013
"969",FALSE,FALSE,"Dave DeBusschere",76545,11,1962,1973
"970",FALSE,FALSE,"Andrew DeClercq",692,9,1995,2004
"971",FALSE,FALSE,"Nate DeLong",76551,0,1951,1951
"972",TRUE,FALSE,"DeMar DeRozan",201942,11,2009,2020
"973",FALSE,FALSE,"Hank DeZonie",76562,0,1950,1950
"974",FALSE,FALSE,"Greg Deane",76544,0,1979,1979
"975",TRUE,TRUE,"Gabriel Deck",1630466,0,2020,2020
"976",TRUE,FALSE,"Dewayne Dedmon",203473,7,2013,2020
"977",FALSE,FALSE,"Archie Dees",76546,3,1958,1961
"978",FALSE,FALSE,"Terry Dehere",143,5,1993,1998
"979",FALSE,FALSE,"Red Dehnert",76548,0,1946,1946
"980",FALSE,FALSE,"Bryce Dejean-Jones",1626214,0,2015,2015
"981",FALSE,FALSE,"Sam Dekker",1626155,3,2015,2018
"982",FALSE,FALSE,"Vinny Del Negro",219,13,1988,2001
"983",FALSE,FALSE,"Malcolm Delaney",1627098,1,2016,2017
"984",FALSE,FALSE,"Bison Dele",183,7,1991,1998
"985",FALSE,FALSE,"Carlos Delfino",2568,9,2004,2013
"986",FALSE,FALSE,"Angel Delgado",1629116,0,2018,2018
"987",FALSE,FALSE,"Tony Delk",960,9,1996,2005
"988",TRUE,FALSE,"Matthew Dellavedova",203521,7,2013,2020
"989",FALSE,FALSE,"Fennis Dembo",76552,0,1988,1988
"990",FALSE,FALSE,"Larry Demic",76553,2,1979,1981
"991",FALSE,FALSE,"Dell Demps",725,3,1993,1996
"992",FALSE,FALSE,"George Dempsey",76555,4,1954,1958
"993",FALSE,FALSE,"Luol Deng",2736,14,2004,2018
"994",FALSE,FALSE,"Kenny Dennard",76556,2,1981,1983
"995",FALSE,FALSE,"Blaine Denning",76557,0,1952,1952
"996",FALSE,FALSE,"Justin Dentmon",202458,1,2011,2012
"997",FALSE,FALSE,"Randy Denton",76558,0,1976,1976
"998",FALSE,FALSE,"Rod Derline",76559,1,1974,1975
"999",FALSE,FALSE,"Marcus Derrickson",1629094,0,2018,2018
"1000",FALSE,FALSE,"Dave Deutsch",76560,0,1966,1966
"1001",FALSE,FALSE,"Walter Devlin",76561,2,1955,1957
"1002",FALSE,FALSE,"Ernie DiGregorio",76568,4,1973,1977
"1003",TRUE,FALSE,"Donte DiVincenzo",1628978,2,2018,2020
"1004",TRUE,TRUE,"Mamadi Diakite",1629603,0,2020,2020
"1005",FALSE,FALSE,"Derrick Dial",1760,4,1999,2003
"1006",FALSE,FALSE,"Cheick Diallo",1627767,3,2016,2019
"1007",TRUE,FALSE,"Hamidou Diallo",1628977,2,2018,2020
"1008",FALSE,FALSE,"Boris Diaw",2564,13,2003,2016
"1009",FALSE,FALSE,"Yakhouba Diawara",200821,3,2006,2009
"1010",FALSE,FALSE,"Guillermo Diaz",200799,0,2007,2007
"1011",FALSE,FALSE,"Dan Dickau",2424,5,2002,2007
"1012",FALSE,FALSE,"Kaniel Dickens",2079,4,2003,2007
"1013",FALSE,FALSE,"Henry Dickerson",76563,1,1975,1976
"1014",FALSE,FALSE,"Michael Dickerson",1722,4,1998,2002
"1015",FALSE,FALSE,"Derrek Dickey",76564,4,1973,1977
"1016",FALSE,FALSE,"Dick Dickey",76565,0,1951,1951
"1017",FALSE,FALSE,"Travis Diener",101143,4,2005,2009
"1018",TRUE,FALSE,"Gorgui Dieng",203476,7,2013,2020
"1019",FALSE,FALSE,"Connie Dierking",76566,12,1958,1970
"1020",FALSE,FALSE,"Coby Dietrick",76567,6,1976,1982
"1021",FALSE,FALSE,"Mickey Dillard",76569,0,1981,1981
"1022",FALSE,FALSE,"Bob Dille",76570,0,1946,1946
"1023",FALSE,FALSE,"John Dillon",76571,0,1949,1949
"1024",FALSE,FALSE,"Byron Dinkins",76574,1,1989,1990
"1025",FALSE,FALSE,"Jackie Dinkins",76575,0,1971,1971
"1026",FALSE,FALSE,"Bill Dinwiddie",76576,4,1967,1971
"1027",TRUE,FALSE,"Spencer Dinwiddie",203915,6,2014,2020
"1028",FALSE,FALSE,"Ike Diogu",101113,6,2005,2011
"1029",FALSE,FALSE,"DeSagana Diop",2205,11,2001,2012
"1030",FALSE,FALSE,"Terry Dischinger",76577,10,1962,1972
"1031",FALSE,FALSE,"Fred Diute",76578,0,1954,1954
"1032",FALSE,FALSE,"Vlade Divac",124,15,1989,2004
"1033",FALSE,FALSE,"Juan Dixon",2413,6,2002,2008
"1034",FALSE,FALSE,"Aleksandar Djordjevic",1059,0,1996,1996
"1035",FALSE,FALSE,"Earl Dodd",76580,0,1949,1949
"1036",FALSE,FALSE,"Michael Doleac",1720,9,1998,2007
"1037",FALSE,FALSE,"Joe Dolhon",76581,1,1949,1950
"1038",FALSE,FALSE,"Bob Doll",76582,3,1946,1949
"1039",FALSE,FALSE,"James Donaldson",76583,14,1980,1994
"1040",TRUE,FALSE,"Luka Doncic",1629029,2,2018,2020
"1041",FALSE,FALSE,"Bob Donham",76584,3,1950,1953
"1042",FALSE,FALSE,"Billy Donovan",76586,0,1987,1987
"1043",FALSE,FALSE,"Harry Donovan",76585,0,1949,1949
"1044",FALSE,FALSE,"Keyon Dooling",2039,12,2000,2012
"1045",FALSE,FALSE,"Jacky Dorsey",76587,3,1977,1980
"1046",FALSE,FALSE,"Joey Dorsey",201595,6,2008,2014
"1047",FALSE,FALSE,"Tyler Dorsey",1628416,1,2017,2018
"1048",TRUE,FALSE,"Luguentz Dort",1629652,1,2019,2020
"1049",TRUE,FALSE,"Damyean Dotson",1628422,3,2017,2020
"1050",TRUE,TRUE,"Devon Dotson",1629653,0,2020,2020
"1051",FALSE,FALSE,"Quincy Douby",200763,2,2006,2008
"1052",FALSE,FALSE,"Bruce Douglas",76588,0,1986,1986
"1053",FALSE,FALSE,"John Douglas",76589,1,1981,1982
"1054",FALSE,FALSE,"Leon Douglas",76590,6,1976,1982
"1055",FALSE,FALSE,"Sherman Douglas",428,11,1989,2000
"1056",FALSE,FALSE,"Toney Douglas",201962,7,2009,2016
"1057",FALSE,FALSE,"Chris Douglas-Roberts",201604,6,2008,2014
"1058",TRUE,FALSE,"Sekou Doumbouya",1629635,1,2019,2020
"1059",FALSE,FALSE,"Lloyd Dove",76592,1,1967,1968
"1060",FALSE,FALSE,"Zabian Dowdell",202220,0,2010,2010
"1061",FALSE,FALSE,"Bill Downey",76593,0,1947,1947
"1062",FALSE,FALSE,"Steve Downing",76594,1,1973,1974
"1063",FALSE,FALSE,"Danny Doyle",76595,0,1962,1962
"1064",FALSE,FALSE,"Milton Doyle",1628495,0,2017,2017
"1065",TRUE,FALSE,"PJ Dozier",1628408,3,2017,2020
"1066",FALSE,FALSE,"Terry Dozier",76596,0,1989,1989
"1067",TRUE,FALSE,"Goran Dragic",201609,12,2008,2020
"1068",FALSE,FALSE,"Zoran Dragic",204054,0,2014,2014
"1069",FALSE,FALSE,"Greg Dreiling",1068,10,1986,1996
"1070",FALSE,FALSE,"Bryce Drew",1724,5,1998,2003
"1071",FALSE,FALSE,"John Drew",76598,10,1974,1984
"1072",FALSE,FALSE,"Larry Drew",76599,10,1980,1990
"1073",FALSE,FALSE,"Larry Drew II",203580,3,2014,2017
"1074",FALSE,FALSE,"Clyde Drexler",17,14,1983,1997
"1075",FALSE,FALSE,"Nate Driggers",1041,0,1996,1996
"1076",FALSE,FALSE,"Terry Driscoll",76603,4,1970,1974
"1077",FALSE,FALSE,"Predrag Drobnjak",1542,3,2001,2004
"1078",FALSE,FALSE,"Ralph Drollinger",76604,0,1980,1980
"1079",TRUE,FALSE,"Andre Drummond",203083,8,2012,2020
"1080",FALSE,FALSE,"Dennis DuVal",76623,1,1974,1975
"1081",FALSE,FALSE,"Dick Duckett",76605,0,1957,1957
"1082",FALSE,FALSE,"Kevin Duckworth",404,10,1986,1996
"1083",FALSE,FALSE,"Charles Dudley",76607,6,1972,1978
"1084",FALSE,FALSE,"Chris Dudley",201,15,1987,2002
"1085",TRUE,FALSE,"Jared Dudley",201162,13,2007,2020
"1086",FALSE,FALSE,"Terry Duerod",76608,3,1979,1982
"1087",FALSE,FALSE,"Bob Duffy",76609,0,1946,1946
"1088",FALSE,FALSE,"Bob Duffy",76610,2,1962,1964
"1089",FALSE,FALSE,"Chris Duhon",2768,8,2004,2012
"1090",FALSE,FALSE,"Duje Dukan",1626251,0,2015,2015
"1091",FALSE,FALSE,"Walter Dukes",76611,7,1955,1962
"1092",FALSE,FALSE,"Joe Dumars",247,13,1985,1998
"1093",FALSE,FALSE,"Richard Dumas",30,3,1992,1995
"1094",FALSE,FALSE,"Tony Dumas",434,3,1994,1997
"1095",FALSE,FALSE,"Andy Duncan",76615,2,1948,1950
"1096",FALSE,FALSE,"Tim Duncan",1495,18,1997,2015
"1097",FALSE,FALSE,"Mike Dunleavy",2399,14,2002,2016
"1098",FALSE,FALSE,"Mike Dunleavy",76616,13,1976,1989
"1099",TRUE,FALSE,"Kris Dunn",1627739,4,2016,2020
"1100",FALSE,FALSE,"Pat Dunn",76617,0,1957,1957
"1101",FALSE,FALSE,"T.R. Dunn",76618,13,1977,1990
"1102",FALSE,FALSE,"Ronald Dupree",2648,7,2003,2010
"1103",TRUE,FALSE,"Kevin Durant",201142,13,2007,2020
"1104",FALSE,FALSE,"John Duren",76619,2,1980,1982
"1105",FALSE,FALSE,"Pat Durham",1090,2,1992,1994
"1106",FALSE,FALSE,"Devin Durrant",76621,1,1984,1985
"1107",FALSE,FALSE,"Ken Durrett",76622,3,1971,1974
"1108",FALSE,FALSE,"Trevon Duval",1628979,0,2018,2018
"1109",FALSE,FALSE,"Jack Dwan",76624,0,1948,1948
"1110",FALSE,FALSE,"Craig Dykema",76625,0,1981,1981
"1111",FALSE,FALSE,"Gene Dyker",76626,0,1953,1953
"1112",FALSE,FALSE,"Jerome Dyson",202406,0,2011,2011
"1113",FALSE,FALSE,"Ledell Eackles",289,9,1988,1997
"1114",FALSE,FALSE,"Jim Eakins",76628,1,1976,1977
"1115",FALSE,FALSE,"Acie Earl",768,3,1993,1996
"1116",FALSE,FALSE,"Ed Earle",76630,0,1953,1953
"1117",FALSE,FALSE,"Cleanthony Early",203921,1,2014,2015
"1118",FALSE,FALSE,"Mark Eaton",76631,10,1982,1992
"1119",FALSE,FALSE,"Jerry Eaves",76632,4,1982,1986
"1120",FALSE,FALSE,"Devin Ebanks",202365,2,2010,2012
"1121",FALSE,FALSE,"Bill Ebben",76633,0,1957,1957
"1122",FALSE,FALSE,"Al Eberhard",76634,3,1974,1977
"1123",FALSE,FALSE,"Ndudi Ebi",2569,1,2003,2004
"1124",FALSE,FALSE,"Jarell Eddie",204067,2,2015,2017
"1125",FALSE,FALSE,"Patrick Eddie",76635,0,1991,1991
"1126",FALSE,FALSE,"Thomas Eddleman",76636,3,1949,1952
"1127",FALSE,FALSE,"Kent Edelin",76637,0,1984,1984
"1128",FALSE,FALSE,"Keith Edmonson",76638,1,1982,1983
"1129",FALSE,FALSE,"Tyus Edney",721,5,1995,2000
"1130",TRUE,TRUE,"Anthony Edwards",1630162,0,2020,2020
"1131",FALSE,FALSE,"Bill Edwards",76646,0,1993,1993
"1132",FALSE,FALSE,"Blue Edwards",898,9,1989,1998
"1133",TRUE,FALSE,"Carsen Edwards",1629035,1,2019,2020
"1134",FALSE,FALSE,"Corsley Edwards",2451,2,2002,2004
"1135",FALSE,FALSE,"Doug Edwards",346,2,1993,1995
"1136",FALSE,FALSE,"Franklin Edwards",76641,6,1981,1987
"1137",FALSE,FALSE,"James Edwards",229,18,1977,1995
"1138",FALSE,FALSE,"Jay Edwards",76643,0,1989,1989
"1139",FALSE,FALSE,"John Edwards",2823,1,2004,2005
"1140",FALSE,FALSE,"Kevin Edwards",236,12,1988,2000
"1141",FALSE,FALSE,"Shane Edwards",202197,0,2013,2013
"1142",FALSE,FALSE,"Vincent Edwards",1629053,0,2018,2018
"1143",FALSE,FALSE,"Johnny Egan",76647,10,1961,1971
"1144",FALSE,FALSE,"Lonnie Eggleston",76648,0,1948,1948
"1145",FALSE,FALSE,"Eddie Ehlers",76649,1,1947,1948
"1146",FALSE,FALSE,"Craig Ehlo",378,13,1983,1996
"1147",FALSE,FALSE,"Dick Eichhorst",76651,0,1961,1961
"1148",FALSE,FALSE,"Howard Eisley",458,11,1994,2005
"1149",FALSE,FALSE,"Obinna Ekezie",1918,5,1999,2004
"1150",FALSE,FALSE,"Khalid El-Amin",2064,2,2000,2002
"1151",FALSE,FALSE,"Don Eliason",76653,0,1946,1946
"1152",FALSE,FALSE,"Mario Elie",53,10,1990,2000
"1153",TRUE,TRUE,"CJ Elleby",1629604,0,2020,2020
"1154",FALSE,FALSE,"Ray Ellefson",76655,2,1948,1950
"1155",FALSE,FALSE,"Henry Ellenson",1627740,4,2016,2020
"1156",TRUE,FALSE,"Wayne Ellington",201961,11,2009,2020
"1157",FALSE,FALSE,"Bob Elliott",76656,2,1978,1980
"1158",FALSE,FALSE,"Sean Elliott",251,11,1989,2000
"1159",FALSE,FALSE,"Alexander Ellis",76658,1,1958,1959
"1160",FALSE,FALSE,"Bo Ellis",76664,2,1977,1979
"1161",FALSE,FALSE,"Dale Ellis",107,16,1983,1999
"1162",FALSE,FALSE,"Harold Ellis",1677,4,1993,1997
"1163",FALSE,FALSE,"Joe Ellis",76661,7,1966,1973
"1164",FALSE,FALSE,"LaPhonso Ellis",111,10,1992,2002
"1165",FALSE,FALSE,"LeRon Ellis",1034,4,1991,1995
"1166",FALSE,FALSE,"Leroy Ellis",76663,13,1962,1975
"1167",FALSE,FALSE,"Monta Ellis",101145,11,2005,2016
"1168",FALSE,FALSE,"Pervis Ellison",442,11,1989,2000
"1169",FALSE,FALSE,"Len Elmore",600010,7,1976,1983
"1170",FALSE,FALSE,"Francisco Elson",1922,8,2003,2011
"1171",FALSE,FALSE,"Darrell Elston",76667,0,1976,1976
"1172",FALSE,FALSE,"Melvin Ely",2408,11,2002,2013
"1173",TRUE,FALSE,"Joel Embiid",203954,6,2014,2020
"1174",FALSE,FALSE,"Wayne Embry",76668,10,1958,1968
"1175",FALSE,FALSE,"Andre Emmett",2765,7,2004,2011
"1176",FALSE,FALSE,"Ned Endress",76669,0,1946,1946
"1177",FALSE,FALSE,"Chris Engler",76670,5,1982,1987
"1178",FALSE,FALSE,"Wayne Englestad",76671,0,1988,1988
"1179",FALSE,FALSE,"A.J. English",76672,1,1990,1991
"1180",FALSE,FALSE,"Alex English",76673,14,1976,1990
"1181",FALSE,FALSE,"Claude English",76674,0,1970,1970
"1182",FALSE,FALSE,"Jojo English",76676,2,1992,1994
"1183",FALSE,FALSE,"Kim English",203119,0,2012,2012
"1184",FALSE,FALSE,"Scott English",76675,0,1972,1972
"1185",FALSE,FALSE,"Gene Englund",76677,0,1949,1949
"1186",FALSE,FALSE,"Tyler Ennis",203898,3,2014,2017
"1187",TRUE,FALSE,"James Ennis III",203516,6,2014,2020
"1188",FALSE,FALSE,"Ray Epps",76678,0,1978,1978
"1189",FALSE,FALSE,"Semih Erden",201623,1,2010,2011
"1190",FALSE,FALSE,"Bo Erias",76679,0,1957,1957
"1191",FALSE,FALSE,"Keith Erickson",76680,11,1965,1976
"1192",FALSE,FALSE,"Julius Erving",76681,10,1976,1986
"1193",FALSE,FALSE,"Evan Eschmeyer",1915,4,1999,2003
"1194",FALSE,FALSE,"Jack Eskridge",76682,0,1948,1948
"1195",FALSE,FALSE,"Vincenzo Esposito",76683,0,1995,1995
"1196",TRUE,FALSE,"Drew Eubanks",1629234,2,2018,2020
"1197",FALSE,FALSE,"Bob Evans",76687,0,1949,1949
"1198",FALSE,FALSE,"Brian Evans",967,2,1996,1998
"1199",FALSE,FALSE,"Earl Evans",76685,0,1979,1979
"1200",FALSE,FALSE,"Jacob Evans",1628980,1,2018,2019
"1201",FALSE,FALSE,"Jawun Evans",1628393,1,2017,2018
"1202",FALSE,FALSE,"Jeremy Evans",202379,7,2010,2017
"1203",FALSE,FALSE,"Maurice Evans",2230,10,2001,2011
"1204",FALSE,FALSE,"Mike Evans",76686,8,1979,1987
"1205",FALSE,FALSE,"Reggie Evans",2501,12,2002,2014
"1206",FALSE,FALSE,"Tyreke Evans",201936,9,2009,2018
"1207",FALSE,FALSE,"Daniel Ewing",101137,1,2005,2006
"1208",FALSE,FALSE,"Patrick Ewing",121,16,1985,2001
"1209",FALSE,FALSE,"Patrick Ewing",201607,0,2010,2010
"1210",TRUE,FALSE,"Dante Exum",203957,6,2014,2020
"1211",FALSE,FALSE,"Christian Eyenga",201963,1,2010,2011
"1212",FALSE,FALSE,"Festus Ezeli",203105,4,2012,2016
"1213",FALSE,FALSE,"Johnny Ezersky",76689,2,1947,1949
"1214",FALSE,FALSE,"Joe Fabel",76690,0,1946,1946
"1215",FALSE,FALSE,"John Fairchild",76691,0,1965,1965
"1216",TRUE,FALSE,"Tacko Fall",1629605,1,2019,2020
"1217",FALSE,FALSE,"Phil Farbman",76692,0,1948,1948
"1218",FALSE,FALSE,"Kenneth Faried",202702,7,2011,2018
"1219",FALSE,FALSE,"Dick Farley",76693,4,1954,1958
"1220",FALSE,FALSE,"Jordan Farmar",200770,10,2006,2016
"1221",FALSE,FALSE,"Desmon Farmer",2824,2,2006,2008
"1222",FALSE,FALSE,"Jim Farmer",76695,6,1987,1993
"1223",FALSE,FALSE,"Mike Farmer",76694,7,1958,1965
"1224",FALSE,FALSE,"Tony Farmer",1108,2,1997,1999
"1225",FALSE,FALSE,"Bob Faught",76696,0,1946,1946
"1226",FALSE,FALSE,"Vitor Faverani",203543,0,2013,2013
"1227",TRUE,FALSE,"Derrick Favors",202324,10,2010,2020
"1228",FALSE,FALSE,"Nick Fazekas",201174,0,2007,2007
"1229",FALSE,FALSE,"Dave Fedor",76697,0,1962,1962
"1230",FALSE,FALSE,"Bob Feerick",76698,3,1946,1949
"1231",FALSE,FALSE,"Butch Feher",76699,0,1976,1976
"1232",FALSE,FALSE,"Jamie Feick",994,6,1996,2002
"1233",FALSE,FALSE,"Ron Feiereisel",76701,0,1955,1955
"1234",FALSE,FALSE,"George Feigenbaum",76702,3,1949,1952
"1235",FALSE,FALSE,"Dave Feitl",76703,5,1986,1991
"1236",FALSE,FALSE,"Kay Felder",1627770,1,2016,2017
"1237",TRUE,FALSE,"Cristiano Felicio",1626245,5,2015,2020
"1238",FALSE,FALSE,"Carrick Felix",203467,0,2013,2013
"1239",FALSE,FALSE,"Noel Felix",101230,0,2005,2005
"1240",FALSE,FALSE,"Ray Felix",76704,8,1953,1961
"1241",FALSE,FALSE,"Raymond Felton",101109,13,2005,2018
"1242",FALSE,FALSE,"Jake Fendley",76705,1,1951,1952
"1243",FALSE,FALSE,"Bill Fenley",76706,0,1946,1946
"1244",FALSE,FALSE,"Desmond Ferguson",2724,0,2003,2003
"1245",FALSE,FALSE,"Terrance Ferguson",1628390,3,2017,2020
"1246",FALSE,FALSE,"Rudy Fernandez",201164,3,2008,2011
"1247",TRUE,FALSE,"Bruno Fernando",1628981,1,2019,2020
"1248",FALSE,FALSE,"Eric Fernsten",76707,8,1975,1983
"1249",FALSE,FALSE,"Al Ferrari",76708,7,1955,1962
"1250",FALSE,FALSE,"Rolando Ferreira",76709,0,1988,1988
"1251",FALSE,FALSE,"Duane Ferrell",273,10,1988,1998
"1252",TRUE,FALSE,"Yogi Ferrell",1627812,4,2016,2020
"1253",FALSE,FALSE,"Arnie Ferrin",76711,2,1948,1950
"1254",FALSE,FALSE,"Bob Ferry",76712,9,1959,1968
"1255",FALSE,FALSE,"Danny Ferry",198,12,1990,2002
"1256",FALSE,FALSE,"Kyrylo Fesenko",201178,4,2007,2011
"1257",FALSE,FALSE,"Kenny Fields",76713,3,1984,1987
"1258",FALSE,FALSE,"Landry Fields",202361,4,2010,2014
"1259",FALSE,FALSE,"Ron Filipek",76714,0,1967,1967
"1260",FALSE,FALSE,"Greg Fillmore",76715,1,1970,1971
"1261",FALSE,FALSE,"Hank Finkel",76716,8,1966,1974
"1262",FALSE,FALSE,"Michael Finley",714,14,1995,2009
"1263",FALSE,FALSE,"Danny Finn",76717,2,1952,1954
"1264",TRUE,FALSE,"Dorian Finney-Smith",1627827,4,2016,2020
"1265",FALSE,FALSE,"Matt Fish",900,2,1994,1996
"1266",FALSE,FALSE,"Derek Fisher",965,17,1996,2013
"1267",FALSE,FALSE,"Gerald Fitch",2809,0,2005,2005
"1268",FALSE,TRUE,"Malik Fitts",1630238,0,2020,2020
"1269",FALSE,FALSE,"Bob Fitzgerald",76720,2,1946,1948
"1270",FALSE,FALSE,"Dick Fitzgerald",76719,1,1946,1947
"1271",FALSE,FALSE,"Marcus Fizer",2033,5,2000,2005
"1272",FALSE,FALSE,"Jerry Fleishman",76721,6,1946,1952
"1273",FALSE,FALSE,"Al Fleming",76722,0,1977,1977
"1274",FALSE,FALSE,"Ed Fleming",76723,4,1955,1959
"1275",FALSE,FALSE,"Vern Fleming",313,11,1984,1995
"1276",FALSE,FALSE,"Luis Flores",2784,0,2004,2004
"1277",FALSE,FALSE,"Bruce Flowers",76725,0,1982,1982
"1278",FALSE,FALSE,"Sleepy Floyd",76726,12,1982,1994
"1279",FALSE,FALSE,"Jonny Flynn",201938,2,2009,2011
"1280",TRUE,TRUE,"Malachi Flynn",1630201,0,2020,2020
"1281",FALSE,FALSE,"Mike Flynn",76727,1,1976,1977
"1282",FALSE,FALSE,"Larry Fogle",76728,0,1975,1975
"1283",FALSE,FALSE,"Jack Foley",76729,0,1962,1962
"1284",FALSE,FALSE,"Ike Fontaine",1829,0,2001,2001
"1285",FALSE,FALSE,"Levi Fontaine",76731,0,1970,1970
"1286",FALSE,FALSE,"Jeff Foote",202880,0,2011,2011
"1287",TRUE,FALSE,"Bryn Forbes",1627854,4,2016,2020
"1288",FALSE,FALSE,"Gary Forbes",201814,1,2010,2011
"1289",FALSE,FALSE,"Alphonso Ford",76732,1,1993,1994
"1290",FALSE,FALSE,"Alton Ford",2228,2,2001,2003
"1291",FALSE,FALSE,"Chris Ford",76733,9,1972,1981
"1292",FALSE,FALSE,"Don Ford",76734,6,1975,1981
"1293",FALSE,FALSE,"Jake Ford",76735,1,1970,1971
"1294",FALSE,FALSE,"Phil Ford",76736,6,1978,1984
"1295",FALSE,FALSE,"Sharrod Ford",101213,0,2005,2005
"1296",FALSE,FALSE,"Sherell Ford",726,0,1995,1995
"1297",FALSE,FALSE,"T.J. Ford",2551,8,2003,2011
"1298",FALSE,FALSE,"Donnie Forman",76738,0,1948,1948
"1299",FALSE,FALSE,"Bayard Forrest",76739,1,1977,1978
"1300",TRUE,TRUE,"Trent Forrest",1630235,0,2020,2020
"1301",FALSE,FALSE,"Joseph Forte",2218,1,2001,2002
"1302",FALSE,FALSE,"Courtney Fortson",202622,0,2011,2011
"1303",FALSE,FALSE,"Danny Fortson",1504,9,1997,2006
"1304",FALSE,FALSE,"Fred Foster",76740,8,1968,1976
"1305",FALSE,FALSE,"Greg Foster",323,12,1990,2002
"1306",FALSE,FALSE,"Jeff Foster",1902,12,1999,2011
"1307",FALSE,FALSE,"Rod Foster",76742,2,1983,1985
"1308",FALSE,FALSE,"Antonis Fotsis",2238,0,2001,2001
"1309",TRUE,FALSE,"Evan Fournier",203095,8,2012,2020
"1310",FALSE,FALSE,"Larry Foust",76744,11,1950,1961
"1311",FALSE,FALSE,"Jerry Fowler",76745,0,1951,1951
"1312",FALSE,FALSE,"Tremaine Fowlkes",1762,3,2001,2004
"1313",TRUE,FALSE,"De'Aaron Fox",1628368,3,2017,2020
"1314",FALSE,FALSE,"Harold Fox",76746,0,1972,1972
"1315",FALSE,FALSE,"Jim Fox",76747,9,1967,1976
"1316",FALSE,FALSE,"Rick Fox",296,12,1991,2003
"1317",FALSE,FALSE,"Randy Foye",200751,10,2006,2016
"1318",FALSE,FALSE,"Adonal Foyle",1502,12,1997,2009
"1319",FALSE,FALSE,"Richie Frahm",2499,5,2002,2007
"1320",FALSE,FALSE,"Steve Francis",1883,8,1999,2007
"1321",FALSE,FALSE,"Tellis Frank",76748,6,1987,1993
"1322",FALSE,FALSE,"Nat Frankel",76749,0,1946,1946
"1323",FALSE,FALSE,"Jamaal Franklin",203479,1,2013,2014
"1324",FALSE,TRUE,"Robert Franks",1629606,0,2020,2020
"1325",TRUE,FALSE,"Tim Frazier",204025,6,2014,2020
"1326",FALSE,FALSE,"Walt Frazier",76750,12,1967,1979
"1327",FALSE,FALSE,"Will Frazier",76751,0,1965,1965
"1328",FALSE,FALSE,"Michael Frazier II",1626187,1,2018,2019
"1329",FALSE,FALSE,"Melvin Frazier Jr.",1628982,1,2018,2019
"1330",FALSE,FALSE,"Anthony Frederick",76752,3,1988,1991
"1331",FALSE,FALSE,"Jimmer Fredette",202690,7,2011,2018
"1332",FALSE,FALSE,"World Free",76753,12,1975,1987
"1333",FALSE,FALSE,"Joel Freeland",200777,2,2012,2014
"1334",FALSE,FALSE,"Donnie Freeman",76754,0,1975,1975
"1335",FALSE,FALSE,"Gary Freeman",76755,0,1970,1970
"1336",FALSE,FALSE,"Rod Freeman",76756,0,1973,1973
"1337",FALSE,FALSE,"Matt Freije",2782,2,2004,2006
"1338",FALSE,FALSE,"Frido Frey",76757,0,1946,1946
"1339",FALSE,FALSE,"Larry Friend",76758,0,1957,1957
"1340",FALSE,FALSE,"Pat Frink",76759,0,1968,1968
"1341",FALSE,FALSE,"Jim Fritsche",76760,1,1953,1954
"1342",FALSE,FALSE,"Channing Frye",101112,13,2005,2018
"1343",FALSE,FALSE,"Bernie Fryer",76761,1,1973,1974
"1344",FALSE,FALSE,"Frank Fucarino",76762,0,1946,1946
"1345",FALSE,FALSE,"Herm Fuetsch",76763,0,1947,1947
"1346",FALSE,FALSE,"Joe Fulks",76764,7,1946,1953
"1347",FALSE,FALSE,"Hiram Fuller",2673,0,2003,2003
"1348",FALSE,FALSE,"Todd Fuller",957,4,1996,2000
"1349",FALSE,FALSE,"Tony Fuller",76765,0,1980,1980
"1350",TRUE,FALSE,"Markelle Fultz",1628365,3,2017,2020
"1351",FALSE,FALSE,"Lawrence Funderburke",1444,7,1997,2004
"1352",FALSE,FALSE,"Terry Furlow",76767,3,1976,1979
"1353",FALSE,FALSE,"Billy Gabor",76768,5,1949,1954
"1354",TRUE,FALSE,"Wenyen Gabriel",1629117,2,2018,2020
"1355",FALSE,FALSE,"Dan Gadzuric",2429,9,2002,2011
"1356",FALSE,FALSE,"Tony Gaffney",202070,0,2009,2009
"1357",TRUE,FALSE,"Daniel Gafford",1629655,1,2019,2020
"1358",FALSE,FALSE,"Deng Gai",101184,0,2005,2005
"1359",FALSE,FALSE,"Elmer R. Gainer",76769,2,1947,1949
"1360",FALSE,FALSE,"Corey Gaines",76770,6,1988,1994
"1361",FALSE,FALSE,"Reece Gaines",2558,2,2003,2005
"1362",FALSE,FALSE,"Sundiata Gaines",202178,2,2009,2011
"1363",FALSE,FALSE,"Mike Gale",76771,5,1976,1981
"1364",FALSE,FALSE,"Chad Gallagher",76772,0,1993,1993
"1365",FALSE,FALSE,"Harry Gallatin",76773,9,1948,1957
"1366",TRUE,FALSE,"Danilo Gallinari",201568,12,2008,2020
"1367",TRUE,FALSE,"Langston Galloway",204038,6,2014,2020
"1368",FALSE,FALSE,"Dave Gambee",76774,11,1958,1969
"1369",FALSE,FALSE,"Kevin Gamble",333,9,1987,1996
"1370",FALSE,FALSE,"Bob Gantt",76776,0,1946,1946
"1371",FALSE,FALSE,"Jorge Garbajosa",200816,1,2006,2007
"1372",FALSE,FALSE,"Ruben Garces",2092,0,2000,2000
"1373",FALSE,FALSE,"Alex Garcia",2682,1,2003,2004
"1374",FALSE,FALSE,"Francisco Garcia",101128,9,2005,2014
"1375",FALSE,FALSE,"Earl Gardner",76778,0,1948,1948
"1376",FALSE,FALSE,"Thomas Gardner",201242,1,2007,2008
"1377",FALSE,FALSE,"Vern Gardner",76779,2,1949,1951
"1378",FALSE,FALSE,"Jack Garfinkel",76780,2,1946,1948
"1379",FALSE,FALSE,"Patricio Garino",1627868,0,2016,2016
"1380",TRUE,FALSE,"Darius Garland",1629636,1,2019,2020
"1381",FALSE,FALSE,"Gary Garland",76781,0,1979,1979
"1382",FALSE,FALSE,"Winston Garland",76782,7,1987,1994
"1383",FALSE,FALSE,"Dick Garmaker",76783,5,1955,1960
"1384",FALSE,FALSE,"Chris Garner",1612,3,1997,2000
"1385",FALSE,FALSE,"Bill Garnett",76785,3,1982,1985
"1386",FALSE,FALSE,"Kevin Garnett",708,20,1995,2015
"1387",FALSE,FALSE,"Marlon Garnett",1831,0,1998,1998
"1388",FALSE,FALSE,"Billy Garrett",1628656,0,2018,2018
"1389",FALSE,FALSE,"Calvin Garrett",76786,3,1980,1983
"1390",FALSE,FALSE,"Dean Garrett",1051,5,1996,2001
"1391",FALSE,FALSE,"Diante Garrett",203197,1,2012,2013
"1392",FALSE,FALSE,"Eldo Garrett",76788,4,1969,1973
"1393",FALSE,FALSE,"Rowland Garrett",76789,4,1972,1976
"1394",FALSE,FALSE,"Tom Garrick",76790,3,1988,1991
"1395",FALSE,FALSE,"John Garris",76791,0,1983,1983
"1396",FALSE,FALSE,"Kiwane Garris",1619,5,1997,2002
"1397",FALSE,FALSE,"Pat Garrity",1727,9,1998,2007
"1398",FALSE,FALSE,"Jim Garvin",76793,0,1973,1973
"1399",TRUE,FALSE,"Marc Gasol",201188,12,2008,2020
"1400",FALSE,FALSE,"Pau Gasol",2200,17,2001,2018
"1401",FALSE,FALSE,"Frank Gates",76794,0,1949,1949
"1402",FALSE,FALSE,"Chris Gatling",423,10,1991,2001
"1403",FALSE,FALSE,"Kenny Gattison",930,9,1986,1995
"1404",TRUE,FALSE,"Rudy Gay",200752,14,2006,2020
"1405",FALSE,FALSE,"Ed Gayda",76797,0,1950,1950
"1406",FALSE,FALSE,"Andrew Gaze",1845,5,1993,1998
"1407",FALSE,FALSE,"Michael Gbinije",1627771,0,2016,2016
"1408",FALSE,FALSE,"Reggie Geary",1002,1,1996,1997
"1409",FALSE,FALSE,"Alonzo Gee",202087,7,2009,2016
"1410",FALSE,FALSE,"Matt Geiger",761,9,1992,2001
"1411",FALSE,FALSE,"Mickael Gelabale",101153,6,2006,2012
"1412",FALSE,FALSE,"Devean George",1904,10,1999,2009
"1413",FALSE,FALSE,"Jack George",76800,7,1953,1960
"1414",TRUE,FALSE,"Paul George",202331,10,2010,2020
"1415",FALSE,FALSE,"Tate George",76801,4,1990,1994
"1416",FALSE,FALSE,"Marcus Georges-Hunt",1627875,1,2016,2017
"1417",FALSE,FALSE,"Gus Gerard",76802,4,1976,1980
"1418",FALSE,FALSE,"Derrick Gervin",76803,1,1989,1990
"1419",FALSE,FALSE,"George Gervin",76804,9,1976,1985
"1420",FALSE,FALSE,"Gorham Getchell",76805,0,1946,1946
"1421",FALSE,FALSE,"John Gianelli",76806,7,1972,1979
"1422",FALSE,FALSE,"Dick Gibbs",76807,4,1971,1975
"1423",FALSE,FALSE,"Daniel Gibson",200789,6,2006,2012
"1424",FALSE,FALSE,"Dee Gibson",76808,0,1949,1949
"1425",FALSE,FALSE,"Jonathan Gibson",1626780,2,2016,2018
"1426",FALSE,FALSE,"Mel Gibson",76809,0,1963,1963
"1427",FALSE,FALSE,"Mike Gibson",76810,2,1983,1985
"1428",TRUE,FALSE,"Taj Gibson",201959,11,2009,2020
"1429",FALSE,FALSE,"Ward Gibson",76811,0,1949,1949
"1430",FALSE,FALSE,"J.R. Giddens",201592,1,2008,2009
"1431",FALSE,FALSE,"Trey Gilder",201821,0,2009,2009
"1432",TRUE,FALSE,"Harry Giles III",1628385,3,2017,2020
"1433",TRUE,FALSE,"Shai Gilgeous-Alexander",1628983,2,2018,2020
"1434",TRUE,TRUE,"Anthony Gill",1630264,0,2020,2020
"1435",FALSE,FALSE,"Eddie Gill",2109,8,2000,2008
"1436",FALSE,FALSE,"Kendall Gill",383,14,1990,2004
"1437",FALSE,FALSE,"Ben Gillery",76812,0,1988,1988
"1438",TRUE,TRUE,"Freddie Gillespie",1630273,0,2020,2020
"1439",FALSE,FALSE,"Gene Gillette",76813,0,1946,1946
"1440",FALSE,FALSE,"Armen Gilliam",288,12,1987,1999
"1441",FALSE,FALSE,"Herm Gilliam",76815,7,1969,1976
"1442",FALSE,FALSE,"Artis Gilmore",600014,11,1976,1987
"1443",FALSE,FALSE,"Walt Gilmore",76817,0,1970,1970
"1444",FALSE,FALSE,"Chuck Gilmur",76818,4,1946,1950
"1445",FALSE,FALSE,"Manu Ginobili",1938,15,2002,2017
"1446",FALSE,FALSE,"Gordan Giricek",1921,5,2002,2007
"1447",FALSE,FALSE,"Jack Givens",76819,1,1978,1979
"1448",FALSE,FALSE,"Mickell Gladness",202148,0,2011,2011
"1449",FALSE,FALSE,"George Glamack",76820,0,1948,1948
"1450",FALSE,FALSE,"Gerald Glass",76821,5,1990,1995
"1451",FALSE,FALSE,"Mike Glenn",76822,9,1977,1986
"1452",FALSE,FALSE,"Norman Glick",76823,0,1949,1949
"1453",FALSE,FALSE,"Georgi Glouchkov",76824,0,1985,1985
"1454",FALSE,FALSE,"Clarence Glover",76825,0,1971,1971
"1455",FALSE,FALSE,"Dion Glover",1901,5,1999,2004
"1456",FALSE,FALSE,"Andreas Glyniadakis",2601,0,2006,2006
"1457",FALSE,FALSE,"Mike Gminski",76826,13,1980,1993
"1458",TRUE,FALSE,"Rudy Gobert",203497,7,2013,2020
"1459",FALSE,FALSE,"Dan Godfread",76827,1,1990,1991
"1460",FALSE,FALSE,"Tom Gola",76828,10,1955,1965
"1461",FALSE,FALSE,"Ben Goldfaden",76829,0,1946,1946
"1462",FALSE,FALSE,"Anthony Goldwire",924,10,1995,2005
"1463",FALSE,FALSE,"Ryan Gomes",101155,8,2005,2013
"1464",FALSE,FALSE,"Glen Gondrezick",76830,5,1977,1982
"1465",FALSE,FALSE,"Grant Gondrezick",76831,2,1986,1988
"1466",FALSE,FALSE,"Drew Gooden",2400,13,2002,2015
"1467",FALSE,FALSE,"Gail Goodrich",76832,13,1965,1978
"1468",FALSE,FALSE,"Steve Goodrich",1864,2,2000,2002
"1469",FALSE,FALSE,"Archie Goodwin",203462,3,2013,2016
"1470",TRUE,FALSE,"Brandon Goodwin",1629164,2,2018,2020
"1471",FALSE,FALSE,"Wilfred Goodwin",76833,1,1946,1947
"1472",TRUE,FALSE,"Aaron Gordon",203932,6,2014,2020
"1473",FALSE,FALSE,"Ben Gordon",2732,10,2004,2014
"1474",FALSE,FALSE,"Drew Gordon",204079,0,2014,2014
"1475",TRUE,FALSE,"Eric Gordon",201569,12,2008,2020
"1476",FALSE,FALSE,"Lancaster Gordon",76834,3,1984,1987
"1477",FALSE,FALSE,"Paul Gordon",76835,0,1949,1949
"1478",FALSE,FALSE,"Marcin Gortat",101162,11,2007,2018
"1479",FALSE,FALSE,"Leo Gottlieb",76836,1,1946,1947
"1480",FALSE,FALSE,"Andrew Goudelock",202726,4,2011,2015
"1481",FALSE,FALSE,"Bato Govedarica",76837,0,1953,1953
"1482",FALSE,FALSE,"Joe Graboski",76838,13,1948,1961
"1483",FALSE,FALSE,"Ricky Grace",76839,0,1993,1993
"1484",TRUE,FALSE,"Devonte' Graham",1628984,2,2018,2020
"1485",FALSE,FALSE,"Greg Graham",37,4,1993,1997
"1486",FALSE,FALSE,"Joey Graham",101121,5,2005,2010
"1487",FALSE,FALSE,"Mal Graham",76843,1,1967,1968
"1488",FALSE,FALSE,"Orlando Graham",76841,0,1988,1988
"1489",FALSE,FALSE,"Paul Graham",76842,2,1991,1993
"1490",FALSE,FALSE,"Stephen Graham",101211,5,2005,2010
"1491",FALSE,FALSE,"Treveon Graham",1626203,3,2016,2019
"1492",FALSE,FALSE,"Jim Grandholm",76844,0,1990,1990
"1493",FALSE,FALSE,"Ronnie Grandison",97,7,1988,1995
"1494",FALSE,FALSE,"Danny Granger",101122,9,2005,2014
"1495",FALSE,FALSE,"Stewart Granger",76847,3,1983,1986
"1496",FALSE,FALSE,"Brian Grant",258,11,1994,2005
"1497",FALSE,FALSE,"Bud Grant",76850,1,1949,1950
"1498",FALSE,FALSE,"Gary Grant",202,12,1988,2000
"1499",FALSE,FALSE,"Greg Grant",285,6,1989,1995
"1500",FALSE,FALSE,"Harvey Grant",265,10,1988,1998
"1501",FALSE,FALSE,"Horace Grant",270,16,1987,2003
"1502",TRUE,FALSE,"Jerami Grant",203924,6,2014,2020
"1503",FALSE,FALSE,"Jerian Grant",1626170,4,2015,2019
"1504",FALSE,FALSE,"Josh Grant",76852,0,1993,1993
"1505",FALSE,FALSE,"Paul Grant",1514,5,1998,2003
"1506",FALSE,FALSE,"Travis Grant",76853,1,1972,1973
"1507",FALSE,FALSE,"Donte Grantham",1629055,0,2018,2018
"1508",FALSE,FALSE,"Don Grate",76854,0,1949,1949
"1509",FALSE,FALSE,"Butch Graves",76855,0,1984,1984
"1510",FALSE,FALSE,"Aaron Gray",201189,6,2007,2013
"1511",FALSE,FALSE,"Devin Gray",1070,3,1996,1999
"1512",FALSE,FALSE,"Ed Gray",1516,1,1997,1998
"1513",FALSE,FALSE,"Evric Gray",1026,0,1996,1996
"1514",FALSE,FALSE,"Gary Gray",76859,0,1967,1967
"1515",FALSE,FALSE,"Josh Gray",1627982,2,2017,2019
"1516",FALSE,FALSE,"Leonard Gray",76860,2,1974,1976
"1517",FALSE,FALSE,"Stuart Gray",76861,6,1984,1990
"1518",FALSE,FALSE,"Sylvester Gray",76862,0,1988,1988
"1519",FALSE,FALSE,"Wyndol Gray",76863,1,1946,1947
"1520",FALSE,FALSE,"Jeff Grayer",81,9,1988,1997
"1521",FALSE,FALSE,"Bob Greacen",76865,1,1969,1970
"1522",FALSE,FALSE,"A.C. Green",920,15,1985,2000
"1523",TRUE,FALSE,"Danny Green",201980,11,2009,2020
"1524",FALSE,FALSE,"Devin Green",101209,0,2005,2005
"1525",TRUE,FALSE,"Draymond Green",203110,8,2012,2020
"1526",FALSE,FALSE,"Erick Green",203475,1,2014,2015
"1527",FALSE,FALSE,"Gerald Green",101123,13,2005,2018
"1528",TRUE,FALSE,"JaMychal Green",203210,6,2014,2020
"1529",TRUE,FALSE,"Javonte Green",1629750,1,2019,2020
"1530",TRUE,FALSE,"Jeff Green",201145,13,2007,2020
"1531",FALSE,FALSE,"Johnny Green",76867,13,1959,1972
"1532",TRUE,TRUE,"Josh Green",1630182,0,2020,2020
"1533",FALSE,FALSE,"Ken Green",76868,0,1985,1985
"1534",FALSE,FALSE,"Kenny Green",76869,1,1985,1986
"1535",FALSE,FALSE,"Lamar Green",600011,5,1969,1974
"1536",FALSE,FALSE,"Litterial Green",1036,6,1992,1998
"1537",FALSE,FALSE,"Luther Green",76872,0,1972,1972
"1538",FALSE,FALSE,"Mike Green",76873,3,1976,1979
"1539",FALSE,FALSE,"Rickey Green",76874,14,1977,1991
"1540",FALSE,FALSE,"Sean Green",76875,2,1991,1993
"1541",FALSE,FALSE,"Si Green",76877,9,1956,1965
"1542",FALSE,FALSE,"Sidney Green",76876,9,1983,1992
"1543",FALSE,FALSE,"Steve Green",76878,2,1976,1978
"1544",FALSE,FALSE,"Taurean Green",201192,0,2007,2007
"1545",FALSE,FALSE,"Tommy Green",76879,0,1978,1978
"1546",FALSE,FALSE,"Willie Green",2584,11,2003,2014
"1547",FALSE,FALSE,"Donte Greene",201590,4,2008,2012
"1548",FALSE,FALSE,"Orien Greene",101158,5,2005,2010
"1549",FALSE,FALSE,"Jerry Greenspan",76880,1,1963,1964
"1550",FALSE,FALSE,"David Greenwood",76881,11,1979,1990
"1551",FALSE,FALSE,"Hal Greer",76882,14,1958,1972
"1552",FALSE,FALSE,"Lynn Greer",2696,0,2006,2006
"1553",FALSE,FALSE,"Gary Gregor",76883,4,1968,1972
"1554",FALSE,FALSE,"Claude Gregory",76884,2,1985,1987
"1555",FALSE,FALSE,"John Greig",76885,0,1982,1982
"1556",FALSE,FALSE,"Norm Grekin",76886,0,1953,1953
"1557",FALSE,FALSE,"Kevin Grevey",76887,9,1975,1984
"1558",FALSE,FALSE,"Adrian Griffin",1559,8,1999,2007
"1559",TRUE,FALSE,"Blake Griffin",201933,11,2009,2020
"1560",FALSE,FALSE,"Eddie Griffin",2204,5,2001,2006
"1561",FALSE,FALSE,"Greg Griffin",76888,0,1977,1977
"1562",FALSE,FALSE,"Paul Griffin",76889,6,1976,1982
"1563",FALSE,FALSE,"Taylor Griffin",201981,0,2009,2009
"1564",FALSE,FALSE,"Darrell Griffith",76890,10,1980,1990
"1565",FALSE,FALSE,"Chuck Grigsby",76891,0,1954,1954
"1566",FALSE,FALSE,"Derek Grimm",1575,0,1997,1997
"1567",FALSE,FALSE,"George Grimshaw",76893,0,1946,1946
"1568",FALSE,FALSE,"Dick Groat",76894,0,1952,1952
"1569",FALSE,FALSE,"Bob Gross",76895,7,1975,1982
"1570",FALSE,FALSE,"Jerry Grote",76896,0,1964,1964
"1571",FALSE,FALSE,"Alex Groza",76897,1,1949,1950
"1572",FALSE,FALSE,"Anthony Grundy",101219,0,2005,2005
"1573",FALSE,FALSE,"Ernie Grunfeld",76899,8,1977,1985
"1574",FALSE,FALSE,"Gene Guarilia",76900,3,1959,1962
"1575",FALSE,FALSE,"Petur Gudmundsson",76901,7,1981,1988
"1576",FALSE,FALSE,"Marko Guduric",1629741,0,2019,2019
"1577",FALSE,FALSE,"Richie Guerin",76902,13,1956,1969
"1578",FALSE,FALSE,"Tom Gugliotta",339,12,1992,2004
"1579",FALSE,FALSE,"Andres Guibert",76903,1,1993,1994
"1580",FALSE,FALSE,"Jay Guidinger",76904,1,1992,1993
"1581",FALSE,FALSE,"Coulby Gunther",76905,2,1946,1948
"1582",FALSE,FALSE,"Dave Gunther",76906,0,1962,1962
"1583",FALSE,FALSE,"Al Guokas",76907,0,1949,1949
"1584",FALSE,FALSE,"Matt Guokas",76908,9,1966,1975
"1585",FALSE,FALSE,"Matt Guokas",76909,0,1946,1946
"1586",FALSE,FALSE,"Jorge Gutierrez",203268,2,2013,2015
"1587",TRUE,FALSE,"Kyle Guy",1629657,1,2019,2020
"1588",FALSE,FALSE,"A.J. Guyton",2062,2,2000,2002
"1589",FALSE,FALSE,"Ha Ha",2775,1,2004,2005
"1590",TRUE,FALSE,"Rui Hachimura",1629060,1,2019,2020
"1591",FALSE,FALSE,"Rudy Hackett",76910,0,1976,1976
"1592",FALSE,FALSE,"Hamed Haddadi",201632,4,2008,2012
"1593",FALSE,FALSE,"Scott Haffner",76911,1,1989,1990
"1594",FALSE,FALSE,"Cliff Hagan",76912,9,1956,1965
"1595",FALSE,FALSE,"Glenn Hagan",76913,0,1981,1981
"1596",FALSE,TRUE,"Ashton Hagans",1630204,0,2020,2020
"1597",FALSE,FALSE,"Bob Hahn",76914,0,1949,1949
"1598",FALSE,FALSE,"Al Hairston",76915,1,1968,1969
"1599",FALSE,FALSE,"Happy Hairston",76916,10,1964,1974
"1600",FALSE,FALSE,"Lindsay Hairston",76917,0,1975,1975
"1601",FALSE,FALSE,"Malik Hairston",201612,1,2008,2009
"1602",FALSE,FALSE,"PJ Hairston",203798,1,2014,2015
"1603",FALSE,FALSE,"Marcus Haislip",2409,7,2002,2009
"1604",FALSE,FALSE,"Chuck Halbert",76918,4,1946,1950
"1605",FALSE,FALSE,"Harvey Halbrook",76919,1,1960,1961
"1606",FALSE,FALSE,"Bruce Hale",76920,2,1948,1950
"1607",FALSE,FALSE,"Jack Haley",917,9,1988,1997
"1608",TRUE,TRUE,"Tyrese Haliburton",1630169,0,2020,2020
"1609",FALSE,FALSE,"Shaler Halimon",76922,3,1968,1971
"1610",FALSE,FALSE,"Devon Hall",1628985,0,2019,2019
"1611",FALSE,FALSE,"Donta Hall",1629743,1,2019,2020
"1612",TRUE,TRUE,"Josh Hall",1630221,0,2020,2020
"1613",FALSE,FALSE,"Mike Hall",200837,0,2006,2006
"1614",FALSE,FALSE,"Jeff Halliburton",76923,1,1971,1972
"1615",FALSE,FALSE,"Darvin Ham",1032,8,1996,2004
"1616",FALSE,FALSE,"Steve Hamer",984,0,1996,1996
"1617",FALSE,FALSE,"Dale Hamilton",76925,0,1949,1949
"1618",FALSE,FALSE,"Daniel Hamilton",1627772,1,2017,2018
"1619",FALSE,FALSE,"Dennis Hamilton",76926,1,1967,1968
"1620",FALSE,FALSE,"Jordan Hamilton",202706,4,2011,2015
"1621",FALSE,FALSE,"Justin Hamilton",203120,3,2013,2016
"1622",FALSE,FALSE,"Ralph Hamilton",76927,0,1948,1948
"1623",FALSE,FALSE,"Richard Hamilton",1888,13,1999,2012
"1624",FALSE,FALSE,"Roylee Hamilton",76928,1,1979,1980
"1625",FALSE,FALSE,"Steve Hamilton",76929,1,1958,1959
"1626",FALSE,FALSE,"Tang Hamilton",2347,1,2001,2002
"1627",FALSE,FALSE,"Thomas Hamilton",676,7,1995,2002
"1628",FALSE,FALSE,"Zendon Hamilton",1985,5,2000,2005
"1629",FALSE,FALSE,"Geert Hammink",903,2,1993,1995
"1630",FALSE,FALSE,"Tom Hammonds",67,11,1989,2000
"1631",FALSE,FALSE,"AJ Hammons",1627773,0,2016,2016
"1632",TRUE,TRUE,"R.J. Hampton",1630181,0,2020,2020
"1633",FALSE,FALSE,"Darrin Hancock",241,2,1994,1996
"1634",FALSE,FALSE,"Ben Handlogten",1052,1,2003,2004
"1635",FALSE,FALSE,"Cecil Hankins",76935,1,1946,1947
"1636",FALSE,FALSE,"Phil Hankinson",76936,1,1973,1974
"1637",FALSE,FALSE,"Dusty Hannahs",1628605,1,2018,2019
"1638",FALSE,FALSE,"Alex Hannum",76937,7,1949,1956
"1639",FALSE,FALSE,"Don Hanrahan",76938,0,1952,1952
"1640",FALSE,FALSE,"Rollen Hans",76939,1,1953,1954
"1641",FALSE,FALSE,"Ben Hansbrough",203162,0,2012,2012
"1642",FALSE,FALSE,"Tyler Hansbrough",201946,6,2009,2015
"1643",FALSE,FALSE,"Bob Hansen",76942,8,1983,1991
"1644",FALSE,FALSE,"Glenn Hansen",76940,2,1975,1977
"1645",FALSE,FALSE,"Lars Hansen",76941,0,1978,1978
"1646",FALSE,FALSE,"Travis Hansen",2580,0,2003,2003
"1647",FALSE,FALSE,"Reggie Hanson",1682,0,1997,1997
"1648",FALSE,FALSE,"Bill Hanzlik",76944,9,1980,1989
"1649",FALSE,FALSE,"Luke Harangody",202376,1,2010,2011
"1650",FALSE,FALSE,"Anfernee Hardaway",358,14,1993,2007
"1651",FALSE,FALSE,"Tim Hardaway",896,13,1989,2002
"1652",TRUE,FALSE,"Tim Hardaway Jr.",203501,7,2013,2020
"1653",TRUE,FALSE,"James Harden",201935,11,2009,2020
"1654",FALSE,FALSE,"Reggie Harding",76945,4,1963,1967
"1655",FALSE,FALSE,"Charlie Hardnett",76946,2,1962,1964
"1656",FALSE,FALSE,"Alan Hardy",76947,1,1980,1981
"1657",FALSE,FALSE,"James Hardy",76948,3,1978,1981
"1658",FALSE,FALSE,"John Hargis",76949,1,1949,1950
"1659",TRUE,FALSE,"Maurice Harkless",203090,8,2012,2020
"1660",FALSE,FALSE,"Jerry Harkness",76950,0,1963,1963
"1661",FALSE,FALSE,"Skip Harlicka",76951,0,1968,1968
"1662",FALSE,FALSE,"Jerome Harmon",76952,0,1994,1994
"1663",FALSE,FALSE,"Derek Harper",157,15,1983,1998
"1664",TRUE,FALSE,"Jared Harper",1629607,1,2019,2020
"1665",FALSE,FALSE,"Justin Harper",202712,5,2011,2016
"1666",FALSE,FALSE,"Mike Harper",76954,1,1980,1981
"1667",FALSE,FALSE,"Ron Harper",166,14,1986,2000
"1668",FALSE,FALSE,"Matt Harpring",1723,10,1998,2008
"1669",TRUE,FALSE,"Montrezl Harrell",1626149,5,2015,2020
"1670",FALSE,FALSE,"Josh Harrellson",202725,2,2011,2013
"1671",FALSE,FALSE,"Adam Harrington",2492,0,2002,2002
"1672",FALSE,FALSE,"Al Harrington",1733,15,1998,2013
"1673",FALSE,FALSE,"Junior Harrington",2454,4,2002,2006
"1674",FALSE,FALSE,"Othella Harrington",970,11,1996,2007
"1675",FALSE,FALSE,"Art Harris",76956,3,1968,1971
"1676",FALSE,FALSE,"Bernie Harris",76957,0,1974,1974
"1677",FALSE,FALSE,"Bob Harris",76959,4,1949,1953
"1678",FALSE,FALSE,"Chris Harris",76958,0,1955,1955
"1679",FALSE,FALSE,"Devin Harris",2734,14,2004,2018
"1680",FALSE,FALSE,"Elias Harris",203548,0,2013,2013
"1681",TRUE,FALSE,"Gary Harris",203914,6,2014,2020
"1682",TRUE,TRUE,"Jalen Harris",1630223,0,2020,2020
"1683",TRUE,FALSE,"Joe Harris",203925,6,2014,2020
"1684",FALSE,FALSE,"Lucious Harris",446,11,1993,2004
"1685",FALSE,FALSE,"Manny Harris",202412,6,2010,2016
"1686",FALSE,FALSE,"Mike Harris",200839,6,2007,2013
"1687",FALSE,FALSE,"Steve Harris",76960,4,1985,1989
"1688",FALSE,FALSE,"Terrel Harris",202227,1,2011,2012
"1689",TRUE,FALSE,"Tobias Harris",202699,9,2011,2020
"1690",FALSE,FALSE,"Tony Harris",76961,4,1990,1994
"1691",FALSE,FALSE,"Aaron Harrison",1626151,2,2015,2017
"1692",FALSE,FALSE,"Andrew Harrison",1626150,2,2016,2018
"1693",FALSE,FALSE,"Bob Harrison",76962,8,1949,1957
"1694",FALSE,FALSE,"David Harrison",2758,3,2004,2007
"1695",TRUE,FALSE,"Shaquille Harrison",1627885,3,2017,2020
"1696",FALSE,FALSE,"Jason Hart",2078,9,2000,2009
"1697",TRUE,FALSE,"Josh Hart",1628404,3,2017,2020
"1698",TRUE,FALSE,"Isaiah Hartenstein",1628392,2,2018,2020
"1699",FALSE,FALSE,"Antonio Harvey",176,9,1993,2002
"1700",FALSE,FALSE,"Donnell Harvey",2051,4,2000,2004
"1701",FALSE,FALSE,"Kenny Hasbrouck",202238,0,2009,2009
"1702",FALSE,FALSE,"Scott Haskin",321,0,1993,1993
"1703",FALSE,FALSE,"Clem Haskins",76965,8,1967,1975
"1704",TRUE,FALSE,"Udonis Haslem",2617,17,2003,2020
"1705",FALSE,FALSE,"Trenton Hassell",2239,8,2001,2009
"1706",FALSE,FALSE,"Billy Hassett",76967,1,1949,1950
"1707",FALSE,FALSE,"Joey Hassett",76966,5,1977,1982
"1708",FALSE,FALSE,"Scott Hastings",76968,10,1982,1992
"1709",FALSE,FALSE,"Kirk Haston",2213,1,2001,2002
"1710",FALSE,FALSE,"Vern Hatton",76969,3,1958,1961
"1711",FALSE,FALSE,"John Havlicek",76970,15,1962,1977
"1712",FALSE,FALSE,"Spencer Hawes",201150,9,2007,2016
"1713",FALSE,FALSE,"Steve Hawes",76971,9,1974,1983
"1714",FALSE,FALSE,"Connie Hawkins",76972,6,1969,1975
"1715",FALSE,FALSE,"Hersey Hawkins",765,12,1988,2000
"1716",FALSE,FALSE,"Juaquin Hawkins",1038,0,2002,2002
"1717",FALSE,FALSE,"Marshall Hawkins",76974,0,1949,1949
"1718",FALSE,FALSE,"Michael Hawkins",1138,4,1996,2000
"1719",FALSE,FALSE,"Robert Hawkins",76975,3,1975,1978
"1720",FALSE,FALSE,"Tom Hawkins",76977,9,1959,1968
"1721",FALSE,FALSE,"Nate Hawthorne",76978,2,1973,1975
"1722",FALSE,FALSE,"Chuck Hayes",101236,10,2005,2015
"1723",FALSE,FALSE,"Elvin Hayes",76979,15,1968,1983
"1724",FALSE,FALSE,"Jarvis Hayes",2553,6,2003,2009
"1725",TRUE,FALSE,"Jaxson Hayes",1629637,1,2019,2020
"1726",TRUE,TRUE,"Killian Hayes",1630165,0,2020,2020
"1727",FALSE,FALSE,"Nigel Hayes",1628502,0,2017,2017
"1728",FALSE,FALSE,"Steve Hayes",76980,4,1981,1985
"1729",TRUE,FALSE,"Gordon Hayward",202330,10,2010,2020
"1730",FALSE,FALSE,"Lazar Hayward",202351,2,2010,2012
"1731",FALSE,FALSE,"Brendan Haywood",2217,13,2001,2014
"1732",FALSE,FALSE,"Spencer Haywood",76981,12,1970,1982
"1733",FALSE,FALSE,"John W. Hazen",76982,0,1948,1948
"1734",FALSE,FALSE,"Walt Hazzard",76983,9,1964,1973
"1735",FALSE,FALSE,"Luther Head",101129,5,2005,2010
"1736",FALSE,FALSE,"Shane Heal",1049,7,1996,2003
"1737",FALSE,FALSE,"Brian Heaney",76984,0,1969,1969
"1738",FALSE,FALSE,"Garfield Heard",76985,10,1970,1980
"1739",FALSE,FALSE,"Reggie Hearn",203687,0,2017,2017
"1740",FALSE,FALSE,"Herm Hedderick",76986,0,1954,1954
"1741",FALSE,FALSE,"Alvin Heggs",76987,0,1995,1995
"1742",FALSE,FALSE,"Tom Heinsohn",76988,8,1956,1964
"1743",FALSE,FALSE,"Dick Hemric",76989,1,1955,1956
"1744",FALSE,FALSE,"Alan Henderson",673,11,1995,2006
"1745",FALSE,FALSE,"Cedric Henderson",1538,5,1997,2002
"1746",FALSE,FALSE,"Cedric Henderson",76990,0,1986,1986
"1747",FALSE,FALSE,"Dave Henderson",76991,0,1987,1987
"1748",FALSE,FALSE,"Gerald Henderson",76993,12,1979,1991
"1749",FALSE,FALSE,"Gerald Henderson",201945,7,2009,2016
"1750",FALSE,FALSE,"J.R. Henderson",1764,0,1998,1998
"1751",FALSE,FALSE,"Jerome Henderson",76992,1,1985,1986
"1752",FALSE,FALSE,"Kevin Henderson",76994,1,1986,1987
"1753",FALSE,FALSE,"Tom Henderson",76996,8,1974,1982
"1754",FALSE,FALSE,"Mark Hendrickson",971,3,1996,1999
"1755",FALSE,FALSE,"Larry Hennessy",76998,0,1955,1955
"1756",FALSE,FALSE,"Don Henriksen",76999,2,1952,1954
"1757",FALSE,FALSE,"Al Henry",77000,1,1970,1971
"1758",FALSE,FALSE,"Bill Henry",77004,1,1948,1949
"1759",FALSE,FALSE,"Carl Henry",77001,0,1985,1985
"1760",FALSE,FALSE,"Conner Henry",77002,1,1986,1987
"1761",FALSE,FALSE,"Myke Henry",1627988,0,2017,2017
"1762",FALSE,FALSE,"Skeeter Henry",77003,0,1993,1993
"1763",FALSE,FALSE,"Xavier Henry",202333,4,2010,2014
"1764",FALSE,FALSE,"John Henson",203089,7,2012,2019
"1765",FALSE,FALSE,"Steve Henson",1667,8,1990,1998
"1766",FALSE,FALSE,"Bill Herman",77006,0,1949,1949
"1767",FALSE,FALSE,"Clarence Hermsen",77007,6,1946,1952
"1768",FALSE,FALSE,"Dewan Hernandez",1629608,0,2019,2019
"1769",TRUE,FALSE,"Juancho Hernangomez",1627823,4,2016,2020
"1770",TRUE,FALSE,"Willy Hernangomez",1626195,4,2016,2020
"1771",FALSE,FALSE,"Chris Herren",1914,1,1999,2000
"1772",FALSE,FALSE,"Carl Herrera",61,7,1991,1998
"1773",FALSE,FALSE,"Walter Herrmann",200835,2,2006,2008
"1774",TRUE,FALSE,"Tyler Herro",1629639,1,2019,2020
"1775",FALSE,FALSE,"Keith Herron",77010,3,1978,1981
"1776",FALSE,FALSE,"Sidney Hertzberg",77011,4,1946,1950
"1777",FALSE,FALSE,"Kevin Hervey",1628987,0,2019,2019
"1778",FALSE,FALSE,"Fred Hetzel",77012,5,1965,1970
"1779",FALSE,FALSE,"Bill Hewitt",77013,6,1968,1974
"1780",FALSE,FALSE,"Jack Hewson",77014,0,1947,1947
"1781",FALSE,FALSE,"Art Heyman",77015,2,1963,1965
"1782",FALSE,FALSE,"Mario Hezonja",1626209,4,2015,2019
"1783",FALSE,FALSE,"Roy Hibbert",201579,8,2008,2016
"1784",FALSE,FALSE,"Matthew Hickey",77016,0,1947,1947
"1785",FALSE,FALSE,"Isaiah Hicks",1628439,1,2017,2018
"1786",FALSE,FALSE,"Phil Hicks",77017,2,1976,1978
"1787",FALSE,FALSE,"JJ Hickson",201581,7,2008,2015
"1788",TRUE,FALSE,"Buddy Hield",1627741,4,2016,2020
"1789",FALSE,FALSE,"Cory Higgins",202809,1,2011,2012
"1790",FALSE,FALSE,"Mike Higgins",1848,1,1989,1990
"1791",FALSE,FALSE,"Rod Higgins",77019,12,1982,1994
"1792",FALSE,FALSE,"Sean Higgins",925,7,1990,1997
"1793",FALSE,FALSE,"Kenny Higgs",77021,3,1978,1981
"1794",FALSE,FALSE,"Johnny High",77022,4,1979,1983
"1795",FALSE,FALSE,"Haywood Highsmith",1629312,0,2018,2018
"1796",FALSE,FALSE,"Wayne Hightower",77023,4,1962,1966
"1797",FALSE,FALSE,"Nene",2403,16,2002,2018
"1798",FALSE,FALSE,"Armond Hill",77024,7,1976,1983
"1799",FALSE,FALSE,"Cleo Hill",77025,0,1961,1961
"1800",FALSE,FALSE,"Gary Hill",77026,1,1963,1964
"1801",TRUE,FALSE,"George Hill",201588,12,2008,2020
"1802",FALSE,FALSE,"Grant Hill",255,18,1994,2012
"1803",FALSE,FALSE,"Herbert Hill",201195,0,2007,2007
"1804",FALSE,FALSE,"Jordan Hill",201941,7,2009,2016
"1805",TRUE,FALSE,"Solomon Hill",203524,7,2013,2020
"1806",FALSE,FALSE,"Steven Hill",201631,0,2008,2008
"1807",FALSE,FALSE,"Tyrone Hill",238,13,1990,2003
"1808",FALSE,FALSE,"Art Hillhouse",77027,1,1946,1947
"1809",FALSE,FALSE,"Darrun Hilliard",1626199,2,2015,2017
"1810",FALSE,FALSE,"Darnell Hillman",77028,3,1976,1979
"1811",FALSE,FALSE,"Fred Hilton",77029,1,1971,1972
"1812",FALSE,FALSE,"Kirk Hinrich",2550,12,2003,2015
"1813",FALSE,FALSE,"Roy Hinson",77030,7,1983,1990
"1814",TRUE,TRUE,"Nate Hinton",1630207,0,2020,2020
"1815",FALSE,FALSE,"Mel Hirsch",77031,0,1946,1946
"1816",FALSE,FALSE,"Lew Hitch",77032,5,1951,1956
"1817",FALSE,FALSE,"Robert Hite",200823,0,2006,2006
"1818",TRUE,FALSE,"Jaylen Hoard",1629658,1,2019,2020
"1819",FALSE,FALSE,"Darington Hobson",202359,0,2011,2011
"1820",FALSE,FALSE,"Donald Hodge",1106,4,1991,1995
"1821",FALSE,FALSE,"Julius Hodge",101125,1,2005,2006
"1822",FALSE,FALSE,"Craig Hodges",77034,9,1982,1991
"1823",FALSE,FALSE,"Adolph Hoefer",77035,1,1946,1947
"1824",FALSE,FALSE,"Bear, The Body Hoffman",77036,7,1947,1954
"1825",FALSE,FALSE,"Bob Hogsett",77037,0,1966,1966
"1826",FALSE,FALSE,"Paul Hogue",77038,1,1962,1963
"1827",FALSE,FALSE,"Fred Hoiberg",697,9,1995,2004
"1828",FALSE,FALSE,"Doug Holcomb",77039,0,1948,1948
"1829",FALSE,FALSE,"Randy Holcomb",2450,3,2002,2005
"1830",TRUE,FALSE,"Aaron Holiday",1628988,2,2018,2020
"1831",TRUE,FALSE,"Jrue Holiday",201950,11,2009,2020
"1832",TRUE,FALSE,"Justin Holiday",203200,8,2012,2020
"1833",FALSE,FALSE,"Brad Holland",77040,2,1979,1981
"1834",FALSE,FALSE,"Joe Holland",77041,2,1949,1951
"1835",FALSE,FALSE,"John Holland",204066,3,2015,2018
"1836",FALSE,FALSE,"Wilbur Holland",77042,3,1975,1978
"1837",FALSE,FALSE,"Lionel Hollins",77043,9,1975,1984
"1838",FALSE,FALSE,"Ryan Hollins",200797,9,2006,2015
"1839",FALSE,FALSE,"Essie Hollis",77044,0,1978,1978
"1840",TRUE,FALSE,"Rondae Hollis-Jefferson",1626178,5,2015,2020
"1841",TRUE,FALSE,"Richaun Holmes",1626158,5,2015,2020
"1842",FALSE,FALSE,"Jim Holstein",77045,3,1952,1955
"1843",FALSE,FALSE,"Alvin Holt",77046,0,1970,1970
"1844",FALSE,FALSE,"Michael Holton",77047,5,1984,1989
"1845",FALSE,FALSE,"Dick Holub",77048,0,1947,1947
"1846",FALSE,FALSE,"Joe Holup",77049,2,1956,1958
"1847",FALSE,FALSE,"Red Holzman",77050,5,1948,1953
"1848",TRUE,TRUE,"Caleb Homesley",1630258,0,2020,2020
"1849",FALSE,FALSE,"Jerald Honeycutt",1532,1,1997,1998
"1850",FALSE,FALSE,"Tyler Honeycutt",202715,1,2011,2012
"1851",FALSE,FALSE,"Derek Hood",1967,3,1999,2002
"1852",TRUE,FALSE,"Rodney Hood",203918,6,2014,2020
"1853",FALSE,FALSE,"Tom Hoover",77051,3,1963,1966
"1854",FALSE,FALSE,"Bob Hopkins",77052,3,1956,1959
"1855",FALSE,FALSE,"Dave Hoppen",77053,5,1987,1992
"1856",FALSE,FALSE,"Dennis Hopson",77054,4,1987,1991
"1857",FALSE,FALSE,"Scotty Hopson",203816,4,2013,2017
"1858",FALSE,FALSE,"Johnny Horan",77055,0,1955,1955
"1859",FALSE,FALSE,"Cedrick Hordges",77056,1,1980,1981
"1860",TRUE,FALSE,"Al Horford",201143,13,2007,2020
"1861",FALSE,FALSE,"Tito Horford",77057,5,1988,1993
"1862",FALSE,FALSE,"Ron Horn",77058,1,1961,1962
"1863",FALSE,FALSE,"Jeff Hornacek",204,13,1986,1999
"1864",FALSE,FALSE,"Dennis Horner",202862,0,2011,2011
"1865",FALSE,FALSE,"Robert Horry",109,15,1992,2007
"1866",FALSE,FALSE,"Ed Horton",77060,0,1989,1989
"1867",TRUE,FALSE,"Talen Horton-Tucker",1629659,1,2019,2020
"1868",FALSE,FALSE,"Wilmer Hosket",77061,3,1968,1971
"1869",FALSE,FALSE,"Bob Houbregs",77062,4,1953,1957
"1870",FALSE,FALSE,"Eddie House",2067,10,2000,2010
"1871",TRUE,FALSE,"Danuel House Jr.",1627863,4,2016,2020
"1872",FALSE,FALSE,"Allan Houston",275,11,1993,2004
"1873",FALSE,FALSE,"Byron Houston",780,3,1992,1995
"1874",FALSE,FALSE,"Tom Hovasse",77064,0,1994,1994
"1875",FALSE,FALSE,"Brian Howard",77065,1,1991,1992
"1876",TRUE,FALSE,"Dwight Howard",2730,16,2004,2020
"1877",FALSE,FALSE,"Greg Howard",77066,1,1970,1971
"1878",FALSE,FALSE,"Josh Howard",2572,9,2003,2012
"1879",FALSE,FALSE,"Juwan Howard",436,18,1994,2012
"1880",TRUE,TRUE,"Markus Howard",1630210,0,2020,2020
"1881",FALSE,FALSE,"Mo Howard",77067,0,1976,1976
"1882",FALSE,FALSE,"Otis Howard",77069,0,1978,1978
"1883",FALSE,FALSE,"Stephen Howard",1128,5,1992,1997
"1884",FALSE,FALSE,"William Howard",1629739,0,2019,2019
"1885",FALSE,FALSE,"Bailey Howell",77070,11,1959,1970
"1886",FALSE,FALSE,"Bob Hubbard",77072,1,1947,1948
"1887",FALSE,FALSE,"Phil Hubbard",77071,9,1979,1988
"1888",FALSE,FALSE,"Lester Hudson",201991,5,2009,2014
"1889",FALSE,FALSE,"Lou Hudson",77074,12,1966,1978
"1890",FALSE,FALSE,"Troy Hudson",1607,10,1997,2007
"1891",FALSE,FALSE,"Marcelo Huertas",1626273,1,2015,2016
"1892",TRUE,FALSE,"Kevin Huerter",1628989,2,2018,2020
"1893",FALSE,FALSE,"Josh Huestis",203962,2,2015,2017
"1894",FALSE,FALSE,"Nate Huffman",1572,0,2002,2002
"1895",FALSE,FALSE,"Alfredrick Hughes",77076,0,1985,1985
"1896",FALSE,FALSE,"Eddie Hughes",77077,2,1987,1989
"1897",TRUE,TRUE,"Elijah Hughes",1630190,0,2020,2020
"1898",FALSE,FALSE,"Kim Hughes",77078,4,1976,1980
"1899",FALSE,FALSE,"Larry Hughes",1716,13,1998,2011
"1900",FALSE,FALSE,"Rick Hughes",1965,0,1999,1999
"1901",FALSE,FALSE,"Robbie Hummel",203133,1,2013,2014
"1902",FALSE,FALSE,"John Hummer",77080,5,1970,1975
"1903",FALSE,FALSE,"Ryan Humphrey",2415,2,2002,2004
"1904",FALSE,FALSE,"Isaac Humphries",1629353,0,2018,2018
"1905",FALSE,FALSE,"Jay Humphries",77081,10,1984,1994
"1906",FALSE,FALSE,"Kris Humphries",2743,12,2004,2016
"1907",FALSE,FALSE,"Rod Hundley",77082,5,1957,1962
"1908",FALSE,FALSE,"Brandon Hunter",2599,1,2003,2004
"1909",FALSE,FALSE,"Cedric Hunter",77083,0,1991,1991
"1910",FALSE,FALSE,"Chris Hunter",201805,1,2008,2009
"1911",TRUE,FALSE,"De'Andre Hunter",1629631,1,2019,2020
"1912",FALSE,FALSE,"Les Hunter",77084,0,1964,1964
"1913",FALSE,FALSE,"Lindsey Hunter",283,16,1993,2009
"1914",FALSE,FALSE,"Othello Hunter",201629,1,2008,2009
"1915",FALSE,FALSE,"RJ Hunter",1626154,3,2015,2018
"1916",FALSE,FALSE,"Steven Hunter",2212,8,2001,2009
"1917",FALSE,FALSE,"Vincent Hunter",1626205,0,2017,2017
"1918",FALSE,FALSE,"Bobby Hurley",310,4,1993,1997
"1919",FALSE,FALSE,"Roy Hurley",77086,0,1946,1946
"1920",FALSE,FALSE,"Geoff Huston",77087,7,1979,1986
"1921",FALSE,FALSE,"Paul Huston",77088,0,1947,1947
"1922",FALSE,FALSE,"Mel Hutchins",77089,6,1951,1957
"1923",TRUE,FALSE,"Chandler Hutchison",1628990,2,2018,2020
"1924",FALSE,FALSE,"Joe Hutton",77090,1,1950,1951
"1925",FALSE,FALSE,"Greg Hyder",77091,0,1970,1970
"1926",FALSE,FALSE,"Marc Iavaroni",77092,6,1982,1988
"1927",TRUE,FALSE,"Serge Ibaka",201586,11,2009,2020
"1928",TRUE,FALSE,"Andre Iguodala",2738,16,2004,2020
"1929",FALSE,FALSE,"Zydrunas Ilgauskas",980,13,1997,2010
"1930",FALSE,FALSE,"Mile Ilic",101148,0,2006,2006
"1931",TRUE,FALSE,"Ersan Ilyasova",101141,14,2006,2020
"1932",FALSE,FALSE,"Darrall Imhoff",77093,11,1960,1971
"1933",FALSE,FALSE,"Tom Ingelsby",77094,0,1973,1973
"1934",TRUE,FALSE,"Joe Ingles",204060,6,2014,2020
"1935",FALSE,FALSE,"Damien Inglis",203996,1,2014,2015
"1936",FALSE,FALSE,"Andre Ingram",201281,1,2017,2018
"1937",TRUE,FALSE,"Brandon Ingram",1627742,4,2016,2020
"1938",FALSE,FALSE,"Joel Ingram",77095,0,1957,1957
"1939",FALSE,FALSE,"Byron Irvin",77096,3,1989,1992
"1940",TRUE,FALSE,"Kyrie Irving",202681,9,2011,2020
"1941",TRUE,FALSE,"Jonathan Isaac",1628371,3,2017,2020
"1942",FALSE,FALSE,"Dan Issel",77097,8,1976,1984
"1943",FALSE,FALSE,"Mike Iuzzolino",77098,1,1991,1992
"1944",FALSE,FALSE,"Allen Iverson",947,13,1996,2009
"1945",FALSE,FALSE,"Royal Ivey",2767,9,2004,2013
"1946",TRUE,FALSE,"Wes Iwundu",1628411,3,2017,2020
"1947",FALSE,FALSE,"Jarrett Jack",101127,12,2005,2017
"1948",FALSE,FALSE,"Aaron Jackson",1628935,0,2017,2017
"1949",FALSE,FALSE,"Al Jackson",77099,0,1967,1967
"1950",FALSE,FALSE,"Bobby Jackson",1517,11,1997,2008
"1951",FALSE,FALSE,"Cedric Jackson",202132,0,2009,2009
"1952",FALSE,FALSE,"Darnell Jackson",201616,2,2008,2010
"1953",FALSE,FALSE,"Demetrius Jackson",1627743,2,2016,2018
"1954",TRUE,FALSE,"Frank Jackson",1628402,3,2017,2020
"1955",FALSE,FALSE,"Greg Jackson",77101,0,1974,1974
"1956",FALSE,FALSE,"Jaren Jackson",1114,12,1989,2001
"1957",FALSE,FALSE,"Jermaine Jackson",1983,6,1999,2005
"1958",FALSE,FALSE,"Jim Jackson",754,13,1992,2005
"1959",TRUE,FALSE,"Josh Jackson",1628367,3,2017,2020
"1960",TRUE,FALSE,"Justin Jackson",1628382,3,2017,2020
"1961",FALSE,FALSE,"Lucious Jackson",77103,7,1964,1971
"1962",FALSE,FALSE,"Luke Jackson",2739,3,2004,2007
"1963",FALSE,FALSE,"Marc Jackson",1531,6,2000,2006
"1964",FALSE,FALSE,"Mark Jackson",349,16,1987,2003
"1965",FALSE,FALSE,"Michael Jackson",77104,2,1987,1989
"1966",FALSE,FALSE,"Myron Jackson",77105,0,1986,1986
"1967",FALSE,FALSE,"Phil Jackson",77106,12,1967,1979
"1968",FALSE,FALSE,"Pierre Jackson",203510,0,2016,2016
"1969",FALSE,FALSE,"Ralph Jackson",77107,0,1984,1984
"1970",FALSE,FALSE,"Randell Jackson",1872,1,1998,1999
"1971",TRUE,FALSE,"Reggie Jackson",202704,9,2011,2020
"1972",FALSE,FALSE,"Stanley Jackson",77109,0,1993,1993
"1973",FALSE,FALSE,"Stephen Jackson",1536,13,2000,2013
"1974",FALSE,FALSE,"Tony Jackson",77100,0,1980,1980
"1975",FALSE,FALSE,"Tracy Jackson",77110,2,1981,1983
"1976",FALSE,FALSE,"Wardell Jackson",77111,0,1974,1974
"1977",TRUE,FALSE,"Jaren Jackson Jr.",1628991,2,2018,2020
"1978",FALSE,FALSE,"Winfred Jacobs",77112,0,1946,1946
"1979",FALSE,FALSE,"Casey Jacobsen",2418,5,2002,2007
"1980",FALSE,FALSE,"Sam Jacobson",1734,2,1998,2000
"1981",FALSE,FALSE,"Dave Jamerson",77114,3,1990,1993
"1982",FALSE,FALSE,"Aaron James",77115,4,1974,1978
"1983",FALSE,FALSE,"Bernard James",203108,2,2012,2014
"1984",FALSE,FALSE,"Damion James",202345,3,2010,2013
"1985",FALSE,FALSE,"Gene James",77116,2,1948,1950
"1986",FALSE,FALSE,"Henry James",1080,7,1990,1997
"1987",FALSE,FALSE,"Jerome James",1744,10,1998,2008
"1988",TRUE,FALSE,"Justin James",1629713,1,2019,2020
"1989",TRUE,FALSE,"LeBron James",2544,17,2003,2020
"1990",FALSE,FALSE,"Mike James",2229,12,2001,2013
"1991",TRUE,FALSE,"Mike James",1628455,3,2017,2020
"1992",FALSE,FALSE,"Tim James",1906,3,1999,2002
"1993",FALSE,FALSE,"Antawn Jamison",1712,15,1998,2013
"1994",FALSE,FALSE,"Harold Jamison",1942,3,1999,2002
"1995",FALSE,FALSE,"John Janisch",77120,1,1946,1947
"1996",FALSE,FALSE,"Howie Janotta",77122,0,1949,1949
"1997",FALSE,FALSE,"Marko Jaric",2060,6,2002,2008
"1998",FALSE,FALSE,"Tony Jaros",77123,4,1946,1950
"1999",FALSE,FALSE,"Sarunas Jasikevicius",101180,1,2005,2006
"2000",FALSE,FALSE,"Nathan Jawai",201605,1,2008,2009
"2001",FALSE,FALSE,"Buddy Jeannette",77125,2,1947,1949
"2002",FALSE,FALSE,"Abdul Jeelani",77126,1,1979,1980
"2003",FALSE,FALSE,"Chris Jefferies",2423,1,2002,2003
"2004",FALSE,FALSE,"Othyus Jeffers",201785,4,2009,2013
"2005",FALSE,FALSE,"Al Jefferson",2744,13,2004,2017
"2006",FALSE,FALSE,"Amile Jefferson",1628518,2,2017,2019
"2007",FALSE,FALSE,"Cory Jefferson",203928,1,2014,2015
"2008",FALSE,FALSE,"Dontell Jefferson",200971,0,2008,2008
"2009",FALSE,FALSE,"Richard Jefferson",2210,16,2001,2017
"2010",TRUE,FALSE,"DaQuan Jeffries",1629610,1,2019,2020
"2011",FALSE,FALSE,"Jared Jeffries",2407,10,2002,2012
"2012",FALSE,FALSE,"Charles Jenkins",202724,1,2011,2012
"2013",FALSE,FALSE,"Horace Jenkins",2798,0,2004,2004
"2014",FALSE,FALSE,"John Jenkins",203098,6,2012,2018
"2015",FALSE,FALSE,"Brandon Jennings",201943,8,2009,2017
"2016",FALSE,FALSE,"Keith Jennings",24,2,1992,1994
"2017",FALSE,FALSE,"Chris Jent",1137,3,1993,1996
"2018",FALSE,FALSE,"Les Jepsen",77129,1,1990,1991
"2019",FALSE,FALSE,"Jonas Jerebko",201973,9,2009,2018
"2020",TRUE,FALSE,"Ty Jerome",1629660,1,2019,2020
"2021",FALSE,FALSE,"Curtis Jerrells",201998,0,2009,2009
"2022",FALSE,FALSE,"Grant Jerrett",203511,1,2013,2014
"2023",FALSE,FALSE,"Pooh Jeter",200817,0,2010,2010
"2024",TRUE,TRUE,"Isaiah Joe",1630198,0,2020,2020
"2025",FALSE,FALSE,"Britton Johnsen",2639,1,2003,2004
"2026",FALSE,FALSE,"Alexander Johnson",200792,3,2006,2009
"2027",TRUE,FALSE,"Alize Johnson",1628993,2,2018,2020
"2028",FALSE,FALSE,"Amir Johnson",101161,13,2005,2018
"2029",FALSE,FALSE,"Andy Johnson",77131,3,1958,1961
"2030",FALSE,FALSE,"Anthony Johnson",1533,12,1997,2009
"2031",FALSE,FALSE,"Armon Johnson",202356,1,2010,2011
"2032",FALSE,FALSE,"Arnie Johnson",77132,4,1948,1952
"2033",FALSE,FALSE,"Avery Johnson",422,15,1988,2003
"2034",FALSE,FALSE,"BJ Johnson",1629168,1,2018,2019
"2035",FALSE,FALSE,"Brice Johnson",1627744,1,2016,2017
"2036",FALSE,FALSE,"Buck Johnson",77130,6,1986,1992
"2037",TRUE,FALSE,"Cameron Johnson",1629661,1,2019,2020
"2038",FALSE,FALSE,"Carldell Johnson",201291,0,2011,2011
"2039",FALSE,FALSE,"Charlie Johnson",77133,6,1972,1978
"2040",FALSE,FALSE,"Chris Johnson",202419,2,2010,2012
"2041",FALSE,FALSE,"Chris Johnson",203187,3,2012,2015
"2042",FALSE,FALSE,"Clay Johnson",77135,2,1981,1983
"2043",FALSE,FALSE,"Clemon Johnson",77136,9,1978,1987
"2044",FALSE,FALSE,"Dakari Johnson",1626177,0,2017,2017
"2045",FALSE,FALSE,"Darryl Johnson",683,0,1995,1995
"2046",FALSE,FALSE,"Dave Johnson",77138,1,1992,1993
"2047",FALSE,FALSE,"David Johnson",77139,3,1949,1952
"2048",FALSE,FALSE,"DeMarco Johnson",1746,0,1999,1999
"2049",FALSE,FALSE,"Dennis Johnson",77141,13,1976,1989
"2050",FALSE,FALSE,"DerMarr Johnson",2035,7,2000,2007
"2051",FALSE,FALSE,"Eddie Johnson",698,17,1981,1998
"2052",FALSE,FALSE,"Eddie Johnson",77144,9,1977,1986
"2053",FALSE,FALSE,"Eric Johnson",77145,0,1989,1989
"2054",FALSE,FALSE,"Ervin Johnson",911,12,1993,2005
"2055",FALSE,FALSE,"Frank Johnson",77146,12,1981,1993
"2056",FALSE,FALSE,"George Johnson",77147,3,1970,1973
"2057",FALSE,FALSE,"George Johnson",77148,7,1978,1985
"2058",FALSE,FALSE,"George Johnson",77149,13,1972,1985
"2059",FALSE,FALSE,"Gus Johnson",77150,9,1963,1972
"2060",FALSE,FALSE,"Harold Johnson",77151,0,1946,1946
"2061",FALSE,FALSE,"Ivan Johnson",201274,1,2011,2012
"2062",FALSE,FALSE,"JaJuan Johnson",202707,0,2011,2011
"2063",TRUE,FALSE,"James Johnson",201949,11,2009,2020
"2064",FALSE,FALSE,"Joe Johnson",2207,16,2001,2017
"2065",FALSE,FALSE,"John Johnson",77152,11,1970,1981
"2066",FALSE,FALSE,"Kannard Johnson",77153,0,1987,1987
"2067",TRUE,FALSE,"Keldon Johnson",1629640,1,2019,2020
"2068",FALSE,FALSE,"Ken Johnson",2256,0,2002,2002
"2069",FALSE,FALSE,"Ken Johnson",77154,0,1985,1985
"2070",FALSE,FALSE,"Kevin Johnson",134,12,1987,1999
"2071",FALSE,FALSE,"Larry Johnson",913,9,1991,2000
"2072",FALSE,FALSE,"Larry Johnson",77156,0,1977,1977
"2073",FALSE,FALSE,"Lee Johnson",77158,0,1980,1980
"2074",FALSE,FALSE,"Linton Johnson",2669,5,2003,2008
"2075",FALSE,FALSE,"Lynbert Johnson",77159,0,1979,1979
"2076",FALSE,FALSE,"Magic Johnson",77142,16,1979,1995
"2077",FALSE,FALSE,"Marques Johnson",77160,12,1977,1989
"2078",FALSE,FALSE,"Mickey Johnson",77168,11,1974,1985
"2079",FALSE,FALSE,"Neil Johnson",77161,3,1966,1969
"2080",FALSE,FALSE,"Nick Johnson",203910,0,2014,2014
"2081",FALSE,FALSE,"Ollie Johnson",77162,9,1972,1981
"2082",FALSE,FALSE,"Omari Johnson",204179,0,2017,2017
"2083",FALSE,FALSE,"Orlando Johnson",203111,3,2012,2015
"2084",FALSE,FALSE,"Reggie Johnson",77163,3,1980,1983
"2085",FALSE,FALSE,"Rich Johnson",77164,2,1968,1970
"2086",FALSE,FALSE,"Ron Johnson",77165,0,1960,1960
"2087",TRUE,FALSE,"Stanley Johnson",1626169,5,2015,2020
"2088",FALSE,FALSE,"Steffond Johnson",77166,0,1986,1986
"2089",FALSE,FALSE,"Steve Johnson",77134,9,1981,1990
"2090",FALSE,FALSE,"Trey Johnson",201234,3,2008,2011
"2091",TRUE,FALSE,"Tyler Johnson",204020,6,2014,2020
"2092",FALSE,FALSE,"Vinnie Johnson",77167,12,1979,1991
"2093",FALSE,FALSE,"Wesley Johnson",202325,8,2010,2018
"2094",FALSE,FALSE,"Darius Johnson-Odom",203130,1,2012,2013
"2095",FALSE,FALSE,"Nate Johnston",77170,0,1989,1989
"2096",FALSE,FALSE,"Neil Johnston",77169,7,1951,1958
"2097",FALSE,FALSE,"Jim Johnstone",77171,0,1982,1982
"2098",TRUE,FALSE,"Nikola Jokic",203999,5,2015,2020
"2099",FALSE,FALSE,"Howie Jolliff",77172,2,1960,1962
"2100",FALSE,FALSE,"Alvin Jones",2264,1,2001,2002
"2101",FALSE,FALSE,"Anthony Jones",77173,3,1986,1989
"2102",FALSE,FALSE,"Askia Jones",77174,0,1994,1994
"2103",FALSE,FALSE,"Bill Jones",77180,0,1988,1988
"2104",FALSE,FALSE,"Bobby Jones",77193,9,1976,1985
"2105",FALSE,FALSE,"Bobby Jones",200784,1,2006,2007
"2106",FALSE,FALSE,"Caldwell Jones",77175,13,1976,1989
"2107",FALSE,FALSE,"Charles Jones",279,14,1983,1997
"2108",FALSE,FALSE,"Charles Jones",77178,4,1984,1988
"2109",FALSE,FALSE,"Charles R. Jones",1869,1,1998,1999
"2110",FALSE,FALSE,"Dahntay Jones",2563,13,2003,2016
"2111",TRUE,FALSE,"Damian Jones",1627745,4,2016,2020
"2112",FALSE,FALSE,"Damon Jones",1800,10,1998,2008
"2113",FALSE,FALSE,"DeQuan Jones",203199,0,2012,2012
"2114",FALSE,FALSE,"Dominique Jones",202346,2,2010,2012
"2115",FALSE,FALSE,"Dontae' Jones",963,0,1997,1997
"2116",FALSE,FALSE,"Dwayne Jones",101204,7,2005,2012
"2117",FALSE,FALSE,"Dwight Jones",77182,9,1973,1982
"2118",FALSE,FALSE,"Earl Jones",77183,1,1984,1985
"2119",FALSE,FALSE,"Eddie Jones",224,13,1994,2007
"2120",FALSE,FALSE,"Edgar Jones",77184,5,1980,1985
"2121",FALSE,FALSE,"Fred Jones",2410,6,2002,2008
"2122",FALSE,FALSE,"Jake Jones",77185,0,1971,1971
"2123",FALSE,FALSE,"Jalen Jones",1627883,1,2017,2018
"2124",FALSE,FALSE,"James Jones",2592,13,2003,2016
"2125",FALSE,FALSE,"Jemerrio Jones",1629203,0,2018,2018
"2126",FALSE,FALSE,"Jimmy Jones",77186,2,1974,1976
"2127",FALSE,FALSE,"Johnny Jones",77187,0,1967,1967
"2128",FALSE,FALSE,"Jumaine Jones",1908,7,1999,2006
"2129",FALSE,FALSE,"K.C. Jones",77188,8,1958,1966
"2130",FALSE,FALSE,"Kevin Jones",203158,0,2012,2012
"2131",FALSE,FALSE,"Larry Jones",77200,9,1964,1973
"2132",FALSE,FALSE,"Major Jones",77189,5,1979,1984
"2133",FALSE,FALSE,"Mark Jones",2891,21,1983,2004
"2134",FALSE,FALSE,"Mark Jones",90000,0,1983,1983
"2135",FALSE,TRUE,"Mason Jones",1630222,0,2020,2020
"2136",FALSE,FALSE,"Nick Jones",77195,4,1967,1971
"2137",FALSE,FALSE,"Ozell Jones",77191,1,1984,1985
"2138",FALSE,FALSE,"Popeye Jones",461,10,1993,2003
"2139",FALSE,FALSE,"Rich Jones",77192,0,1976,1976
"2140",FALSE,FALSE,"Robin Jones",77194,1,1976,1977
"2141",FALSE,FALSE,"Sam Jones",77196,11,1957,1968
"2142",FALSE,FALSE,"Shelton Jones",2652,0,1988,1988
"2143",FALSE,FALSE,"Solomon Jones",200780,7,2006,2013
"2144",FALSE,FALSE,"Steve Jones",77197,0,1975,1975
"2145",FALSE,FALSE,"Terrence Jones",203093,6,2012,2018
"2146",TRUE,TRUE,"Tre Jones",1630200,0,2020,2020
"2147",TRUE,FALSE,"Tyus Jones",1626145,5,2015,2020
"2148",FALSE,FALSE,"Wali Jones",77198,11,1964,1975
"2149",FALSE,FALSE,"Wallace Jones",77199,2,1949,1951
"2150",FALSE,FALSE,"Wil Jones",77201,1,1976,1977
"2151",FALSE,FALSE,"Willie Jones",77202,4,1960,1964
"2152",FALSE,FALSE,"Willie Jones",77203,1,1982,1983
"2153",FALSE,FALSE,"Perry Jones III",203103,2,2012,2014
"2154",TRUE,FALSE,"Derrick Jones Jr.",1627884,4,2016,2020
"2155",FALSE,FALSE,"Adonis Jordan",1817,5,1993,1998
"2156",TRUE,FALSE,"DeAndre Jordan",201599,12,2008,2020
"2157",FALSE,FALSE,"Eddie Jordan",77205,6,1977,1983
"2158",FALSE,FALSE,"Jerome Jordan",202366,3,2011,2014
"2159",FALSE,FALSE,"Michael Jordan",893,18,1984,2002
"2160",FALSE,FALSE,"Reggie Jordan",674,6,1993,1999
"2161",FALSE,FALSE,"Thomas Jordan",77208,0,1992,1992
"2162",FALSE,FALSE,"Walter Jordan",77209,0,1980,1980
"2163",FALSE,FALSE,"Phil Jordon",77210,6,1956,1962
"2164",FALSE,FALSE,"Johnny Jorgensen",77211,1,1947,1948
"2165",FALSE,FALSE,"Noble Jorgensen",77212,6,1946,1952
"2166",FALSE,FALSE,"Roger Jorgensen",77213,0,1946,1946
"2167",TRUE,FALSE,"Cory Joseph",202709,9,2011,2020
"2168",FALSE,FALSE,"Garth Joseph",2123,0,2000,2000
"2169",FALSE,FALSE,"Kris Joseph",203126,0,2012,2012
"2170",FALSE,FALSE,"Yvon Joseph",77214,0,1985,1985
"2171",FALSE,FALSE,"Jeff Judkins",77215,4,1978,1982
"2172",TRUE,FALSE,"Mfiondu Kabengele",1629662,1,2019,2020
"2173",FALSE,FALSE,"Edwin Kachan",77217,0,1948,1948
"2174",FALSE,FALSE,"George Kaftan",77218,4,1948,1952
"2175",FALSE,FALSE,"Ed Kalafat",77219,2,1954,1956
"2176",FALSE,FALSE,"Chris Kaman",2549,12,2003,2015
"2177",TRUE,FALSE,"Frank Kaminsky",1626163,5,2015,2020
"2178",TRUE,FALSE,"Enes Kanter",202683,9,2011,2020
"2179",FALSE,FALSE,"Ralph Kaplowitz",77221,1,1946,1947
"2180",FALSE,FALSE,"Jason Kapono",2574,8,2003,2011
"2181",FALSE,FALSE,"Tony Kappen",77222,0,1946,1946
"2182",FALSE,FALSE,"Sergey Karasev",203508,2,2013,2015
"2183",FALSE,FALSE,"Coby Karl",201207,2,2007,2009
"2184",FALSE,FALSE,"George Karl",77223,1,1976,1977
"2185",FALSE,FALSE,"Ed Kasid",77225,0,1946,1946
"2186",FALSE,FALSE,"Mario Kasun",2435,1,2004,2005
"2187",FALSE,FALSE,"Leo Katkaveck",77226,1,1948,1949
"2188",FALSE,FALSE,"Bob Kauffman",77227,6,1968,1974
"2189",FALSE,FALSE,"Sasha Kaun",201619,0,2015,2015
"2190",FALSE,FALSE,"Wilbert Kautz",77228,0,1946,1946
"2191",FALSE,FALSE,"Clarence Kea",77229,1,1980,1981
"2192",FALSE,FALSE,"Michael Kearns",77230,0,1954,1954
"2193",FALSE,FALSE,"Tommy Kearns",77231,0,1958,1958
"2194",FALSE,FALSE,"Adam Keefe",228,8,1992,2000
"2195",FALSE,FALSE,"Harold Keeling",77233,0,1985,1985
"2196",FALSE,FALSE,"Ken Keller",77234,0,1946,1946
"2197",FALSE,FALSE,"Rich Kelley",77235,10,1975,1985
"2198",FALSE,FALSE,"Clark Kellogg",77236,4,1982,1986
"2199",FALSE,FALSE,"Gerard Kelly",77237,1,1946,1947
"2200",FALSE,FALSE,"Ryan Kelly",203527,3,2013,2016
"2201",FALSE,FALSE,"Tom Kelly",77238,0,1948,1948
"2202",FALSE,FALSE,"Greg Kelser",77239,5,1979,1984
"2203",FALSE,FALSE,"Ben Kelso",77240,0,1973,1973
"2204",FALSE,FALSE,"Shawn Kemp",431,13,1989,2002
"2205",FALSE,FALSE,"Tim Kempton",1118,11,1986,1997
"2206",FALSE,FALSE,"Frank Kendrick",77242,0,1974,1974
"2207",TRUE,FALSE,"Luke Kennard",1628379,3,2017,2020
"2208",FALSE,FALSE,"D.J. Kennedy",202810,0,2011,2011
"2209",FALSE,FALSE,"Eugene Kennedy",77243,0,1976,1976
"2210",FALSE,FALSE,"Joe Kennedy",77244,1,1968,1969
"2211",FALSE,FALSE,"William Kennedy",77245,0,1960,1960
"2212",FALSE,FALSE,"Larry Kenon",77246,6,1976,1982
"2213",FALSE,FALSE,"Bill Kenville",77247,6,1953,1959
"2214",FALSE,FALSE,"Jonathan Kerner",1801,4,1998,2002
"2215",FALSE,FALSE,"Johnny Kerr",77248,11,1954,1965
"2216",FALSE,FALSE,"Steve Kerr",70,14,1988,2002
"2217",FALSE,FALSE,"Jack Kerris",77249,3,1949,1952
"2218",FALSE,FALSE,"Jerome Kersey",760,16,1984,2000
"2219",FALSE,FALSE,"Alec Kessler",77251,3,1990,1993
"2220",FALSE,FALSE,"Lari Ketner",1930,1,1999,2000
"2221",FALSE,FALSE,"Randolph Keys",705,7,1988,1995
"2222",FALSE,FALSE,"Viktor Khryapa",2751,3,2004,2007
"2223",FALSE,FALSE,"Jason Kidd",467,18,1994,2012
"2224",FALSE,FALSE,"Stanton Kidd",1629742,0,2019,2019
"2225",FALSE,FALSE,"Warren Kidd",77254,0,1993,1993
"2226",FALSE,FALSE,"Michael Kidd-Gilchrist",203077,7,2012,2019
"2227",FALSE,FALSE,"Irv Kiffin",77255,0,1979,1979
"2228",FALSE,FALSE,"Jack Kiley",77256,1,1951,1952
"2229",FALSE,FALSE,"Ernie Killum",77257,0,1970,1970
"2230",FALSE,FALSE,"Carl Kilpatrick",77258,0,1979,1979
"2231",FALSE,FALSE,"Sean Kilpatrick",203930,3,2014,2017
"2232",FALSE,FALSE,"Toby Kimball",77259,8,1966,1974
"2233",FALSE,FALSE,"Bo Kimble",77260,2,1990,1992
"2234",FALSE,FALSE,"Stan Kimbrough",77261,3,1989,1992
"2235",FALSE,FALSE,"Chad Kinch",77262,0,1980,1980
"2236",FALSE,FALSE,"Albert King",77263,10,1981,1991
"2237",FALSE,FALSE,"Bernard King",77264,15,1977,1992
"2238",FALSE,FALSE,"Chris King",12,5,1993,1998
"2239",FALSE,FALSE,"Dan King",77266,0,1954,1954
"2240",FALSE,FALSE,"Frankie King",701,1,1995,1996
"2241",FALSE,FALSE,"George King",77268,6,1951,1957
"2242",FALSE,FALSE,"George King",1628994,0,2018,2018
"2243",FALSE,FALSE,"Gerard King",1562,2,1998,2000
"2244",FALSE,FALSE,"Jim King",77270,9,1963,1972
"2245",FALSE,FALSE,"Jimmy King",728,1,1995,1996
"2246",TRUE,FALSE,"Louis King",1629663,1,2019,2020
"2247",FALSE,FALSE,"Maury King",77272,3,1959,1962
"2248",FALSE,FALSE,"Reggie King",77273,5,1979,1984
"2249",FALSE,FALSE,"Rich King",1101,3,1991,1994
"2250",FALSE,FALSE,"Stacey King",351,7,1989,1996
"2251",FALSE,FALSE,"Tom King",77276,0,1946,1946
"2252",FALSE,FALSE,"Bob Kinney",77277,1,1948,1949
"2253",FALSE,FALSE,"Tarence Kinsey",200814,2,2006,2008
"2254",FALSE,FALSE,"Andrei Kirilenko",1905,13,2001,2014
"2255",FALSE,FALSE,"Alex Kirk",203945,0,2014,2014
"2256",FALSE,FALSE,"Walt Kirk",77278,3,1948,1951
"2257",FALSE,FALSE,"Doug Kistler",77279,0,1961,1961
"2258",FALSE,FALSE,"Curtis Kitchen",77280,0,1986,1986
"2259",FALSE,FALSE,"Greg Kite",1123,11,1983,1994
"2260",FALSE,FALSE,"Kerry Kittles",954,8,1996,2004
"2261",TRUE,FALSE,"Maxi Kleber",1628467,3,2017,2020
"2262",FALSE,FALSE,"Joe Kleine",170,14,1985,1999
"2263",FALSE,FALSE,"Linas Kleiza",101132,7,2005,2012
"2264",FALSE,FALSE,"Leo Klier",77283,1,1948,1949
"2265",FALSE,FALSE,"Herm Klotz",77284,0,1947,1947
"2266",FALSE,FALSE,"Duane Klueh",77285,1,1949,1950
"2267",FALSE,FALSE,"Billy Knight",77290,8,1976,1984
"2268",FALSE,FALSE,"Bob Knight",77287,0,1954,1954
"2269",FALSE,FALSE,"Brandin Knight",2688,0,2004,2004
"2270",FALSE,FALSE,"Brandon Knight",202688,8,2011,2019
"2271",FALSE,FALSE,"Brevin Knight",1510,11,1997,2008
"2272",TRUE,TRUE,"Nathan Knight",1630233,0,2020,2020
"2273",FALSE,FALSE,"Negele Knight",1861,8,1990,1998
"2274",FALSE,FALSE,"Ron Knight",77288,1,1970,1971
"2275",FALSE,FALSE,"Toby Knight",77289,4,1977,1981
"2276",FALSE,FALSE,"Travis Knight",969,6,1996,2002
"2277",FALSE,FALSE,"Lee Knorek",77291,3,1946,1949
"2278",FALSE,FALSE,"Dick Knostman",77292,0,1953,1953
"2279",FALSE,FALSE,"Rod Knowles",77293,0,1968,1968
"2280",TRUE,FALSE,"Kevin Knox II",1628995,2,2018,2020
"2281",FALSE,FALSE,"Bart Kofoed",77294,5,1987,1992
"2282",FALSE,FALSE,"Don Kojis",77295,11,1963,1974
"2283",FALSE,FALSE,"Milo Komenich",77296,0,1949,1949
"2284",FALSE,FALSE,"Howard Komives",77297,9,1964,1973
"2285",FALSE,FALSE,"Jon Koncak",402,10,1985,1995
"2286",TRUE,FALSE,"John Konchar",1629723,1,2019,2020
"2287",FALSE,FALSE,"Bud Koper",77299,0,1964,1964
"2288",FALSE,FALSE,"Joe Kopicki",77300,2,1982,1984
"2289",TRUE,FALSE,"Furkan Korkmaz",1627788,3,2017,2020
"2290",FALSE,FALSE,"Frank Kornet",77301,1,1989,1990
"2291",TRUE,FALSE,"Luke Kornet",1628436,3,2017,2020
"2292",FALSE,FALSE,"Yaroslav Korolev",101117,1,2005,2006
"2293",FALSE,FALSE,"Kyle Korver",2594,16,2003,2019
"2294",FALSE,FALSE,"Len Kosmalski",77302,1,1974,1975
"2295",FALSE,FALSE,"Andy Kostecka",77303,0,1948,1948
"2296",FALSE,FALSE,"Harold Kottman",77304,0,1946,1946
"2297",FALSE,FALSE,"Kosta Koufos",201585,10,2008,2018
"2298",FALSE,FALSE,"Tom Kozelko",77305,2,1973,1975
"2299",FALSE,FALSE,"Arvid Kramer",77306,0,1979,1979
"2300",FALSE,FALSE,"Barry Kramer",77307,0,1964,1964
"2301",FALSE,FALSE,"Joel Kramer",77308,4,1978,1982
"2302",FALSE,FALSE,"Dan Kraus",77309,0,1948,1948
"2303",FALSE,FALSE,"Herb Krautblatt",77310,0,1948,1948
"2304",FALSE,FALSE,"Viacheslav Kravtsov",203139,1,2012,2013
"2305",FALSE,FALSE,"Jim Krebs",77311,6,1957,1963
"2306",FALSE,FALSE,"Wayne Kreklow",77312,0,1980,1980
"2307",FALSE,FALSE,"Tom Kron",77313,2,1966,1968
"2308",FALSE,FALSE,"Tom Kropp",77314,1,1975,1976
"2309",FALSE,FALSE,"Nenad Krstic",2420,6,2004,2010
"2310",FALSE,FALSE,"Larry Krystkowiak",1474,10,1986,1996
"2311",FALSE,FALSE,"Steve Kuberski",77316,8,1969,1977
"2312",FALSE,FALSE,"Leo Kubiak",77317,0,1949,1949
"2313",FALSE,FALSE,"Bruce Kuczenski",77318,0,1983,1983
"2314",FALSE,FALSE,"Frank Kudelka",77319,3,1949,1952
"2315",FALSE,FALSE,"John Kuester",77320,2,1977,1979
"2316",FALSE,FALSE,"Ray Kuka",77322,1,1947,1948
"2317",FALSE,FALSE,"Toni Kukoc",389,12,1993,2005
"2318",FALSE,FALSE,"Kevin Kunnert",77323,8,1973,1981
"2319",FALSE,FALSE,"Mitch Kupchak",77324,9,1976,1985
"2320",FALSE,FALSE,"Charles Kupec",77325,2,1975,1977
"2321",FALSE,FALSE,"Rodions Kurucs",1629066,2,2018,2020
"2322",FALSE,FALSE,"Rob Kurz",201633,1,2008,2009
"2323",FALSE,FALSE,"Ibrahim Kutluay",2825,0,2004,2004
"2324",TRUE,FALSE,"Kyle Kuzma",1628398,3,2017,2020
"2325",FALSE,FALSE,"Ognjen Kuzmic",203136,1,2013,2014
"2326",FALSE,FALSE,"Mindaugas Kuzminskas",1627851,1,2016,2017
"2327",FALSE,FALSE,"Fred LaCour",77327,2,1960,1962
"2328",FALSE,FALSE,"Raef LaFrentz",1711,10,1998,2008
"2329",FALSE,FALSE,"Tom LaGarde",77328,7,1977,1984
"2330",FALSE,FALSE,"Rusty LaRue",1601,6,1997,2003
"2331",FALSE,FALSE,"Rudy LaRusso",77340,9,1959,1968
"2332",TRUE,FALSE,"Zach LaVine",203897,6,2014,2020
"2333",FALSE,FALSE,"Skal Labissiere",1627746,3,2016,2019
"2334",FALSE,FALSE,"Sam Lacey",77326,12,1970,1982
"2335",FALSE,FALSE,"Christian Laettner",363,12,1992,2004
"2336",FALSE,FALSE,"Oliver Lafayette",201802,0,2009,2009
"2337",FALSE,FALSE,"Bill Laimbeer",100263,13,1980,1993
"2338",FALSE,FALSE,"Pete Lalich",77329,0,1946,1946
"2339",FALSE,FALSE,"Bo Lamar",77330,0,1976,1976
"2340",TRUE,TRUE,"Anthony Lamb",1630237,0,2020,2020
"2341",FALSE,FALSE,"Doron Lamb",203117,1,2012,2013
"2342",TRUE,FALSE,"Jeremy Lamb",203087,8,2012,2020
"2343",FALSE,FALSE,"John Lambert",77331,6,1975,1981
"2344",FALSE,FALSE,"Jeff Lamp",77332,7,1981,1988
"2345",FALSE,FALSE,"Maciej Lampe",2573,2,2003,2005
"2346",FALSE,FALSE,"Jim Lampley",77333,0,1986,1986
"2347",FALSE,FALSE,"Sean Lampley",2253,1,2002,2003
"2348",FALSE,FALSE,"Carl Landry",201171,8,2007,2015
"2349",FALSE,FALSE,"Marcus Landry",202068,0,2009,2009
"2350",FALSE,FALSE,"Mark Landsberger",77334,6,1977,1983
"2351",FALSE,FALSE,"Jerome Lane",77335,4,1988,1992
"2352",FALSE,FALSE,"Andrew Lang",457,11,1988,1999
"2353",FALSE,FALSE,"Antonio Lang",226,5,1994,1999
"2354",FALSE,FALSE,"James Lang",2591,0,2006,2006
"2355",FALSE,FALSE,"Trajan Langdon",1892,2,1999,2001
"2356",FALSE,FALSE,"Keith Langford",101247,0,2007,2007
"2357",TRUE,FALSE,"Romeo Langford",1629641,1,2019,2020
"2358",FALSE,FALSE,"Dan Langhi",2061,3,2000,2003
"2359",FALSE,FALSE,"Bob Lanier",600005,13,1970,1983
"2360",FALSE,FALSE,"Stu Lantz",77338,7,1968,1975
"2361",FALSE,FALSE,"Nicolas Laprovittola",1627879,0,2016,2016
"2362",FALSE,FALSE,"York Larese",77339,0,1961,1961
"2363",FALSE,FALSE,"Shane Larkin",203499,4,2013,2017
"2364",FALSE,FALSE,"John Laskowski",77341,1,1975,1976
"2365",FALSE,FALSE,"Stephane Lasme",201186,0,2007,2007
"2366",FALSE,FALSE,"Dave Lattin",77342,1,1967,1968
"2367",FALSE,FALSE,"Priest Lauderdale",968,1,1996,1997
"2368",FALSE,FALSE,"Rich Laurel",77344,0,1977,1977
"2369",FALSE,FALSE,"Walt Lautenbach",77345,0,1949,1949
"2370",FALSE,FALSE,"Joffrey Lauvergne",203530,3,2014,2017
"2371",FALSE,FALSE,"Tony Lavelli",77346,1,1949,1950
"2372",FALSE,FALSE,"Bob Lavoy",77347,3,1950,1953
"2373",FALSE,FALSE,"Acie Law",201151,3,2007,2010
"2374",FALSE,FALSE,"Vic Law",1629724,0,2019,2019
"2375",FALSE,FALSE,"Gani Lawal",202371,0,2010,2010
"2376",FALSE,FALSE,"Ed Lawrence",77348,0,1980,1980
"2377",FALSE,FALSE,"Jason Lawson",1535,5,1997,2002
"2378",FALSE,FALSE,"Ty Lawson",201951,8,2009,2017
"2379",TRUE,FALSE,"Jake Layman",1627774,4,2016,2020
"2380",FALSE,FALSE,"Dennis Layton",77350,6,1971,1977
"2381",TRUE,FALSE,"Caris LeVert",1627747,4,2016,2020
"2382",TRUE,FALSE,"T.J. Leaf",1628388,3,2017,2020
"2383",FALSE,FALSE,"Emanuel Leaks",77351,1,1972,1973
"2384",FALSE,FALSE,"Hal Lear",77352,0,1956,1956
"2385",FALSE,FALSE,"Allen Leavell",77353,9,1979,1988
"2386",FALSE,FALSE,"Jeff Lebo",77354,0,1989,1989
"2387",FALSE,FALSE,"Eric Leckner",287,8,1988,1996
"2388",FALSE,FALSE,"Jalen Lecque",1629665,1,2019,2020
"2389",FALSE,FALSE,"Ricky Ledo",203495,1,2013,2014
"2390",FALSE,FALSE,"Butch Lee",77356,1,1978,1979
"2391",FALSE,FALSE,"Clyde Lee",77357,9,1966,1975
"2392",FALSE,FALSE,"Courtney Lee",201584,11,2008,2019
"2393",TRUE,FALSE,"Damion Lee",1627814,3,2017,2020
"2394",FALSE,FALSE,"David Lee",101135,11,2005,2016
"2395",FALSE,FALSE,"Doug Lee",77358,3,1991,1994
"2396",FALSE,FALSE,"George Lee",77359,7,1960,1967
"2397",FALSE,FALSE,"Greg Lee",77360,0,1975,1975
"2398",FALSE,FALSE,"Keith Lee",77361,3,1985,1988
"2399",FALSE,FALSE,"Kurk Lee",77362,0,1990,1990
"2400",FALSE,FALSE,"Malcolm Lee",202723,3,2011,2014
"2401",FALSE,FALSE,"Rock Lee",77363,0,1981,1981
"2402",FALSE,FALSE,"Ron Lee",77364,5,1976,1981
"2403",FALSE,FALSE,"Russell Lee",77365,2,1972,1974
"2404",TRUE,TRUE,"Saben Lee",1630240,0,2020,2020
"2405",FALSE,FALSE,"Ed Leede",77366,1,1949,1950
"2406",FALSE,FALSE,"Hank Lefkowitz",77367,0,1946,1946
"2407",FALSE,FALSE,"Tim Legler",100,10,1989,1999
"2408",FALSE,FALSE,"George Lehmann",77369,1,1967,1968
"2409",FALSE,FALSE,"Walt Lemon Jr.",1627215,1,2017,2018
"2410",TRUE,FALSE,"Alex Len",203458,7,2013,2020
"2411",FALSE,FALSE,"Voshon Lenard",702,10,1995,2005
"2412",FALSE,FALSE,"Bob Leonard",77371,6,1956,1962
"2413",FALSE,FALSE,"Gary Leonard",77370,2,1989,1991
"2414",TRUE,FALSE,"Kawhi Leonard",202695,9,2011,2020
"2415",FALSE,FALSE,"Meyers Leonard",203086,8,2012,2020
"2416",FALSE,FALSE,"Jim Les",77372,6,1988,1994
"2417",FALSE,FALSE,"Travis Leslie",202727,0,2011,2011
"2418",FALSE,FALSE,"Ronnie Lester",77373,5,1980,1985
"2419",FALSE,FALSE,"Clifford Lett",77374,1,1989,1990
"2420",FALSE,FALSE,"Jon Leuer",202720,7,2011,2018
"2421",FALSE,FALSE,"Andrew Levane",77375,4,1948,1952
"2422",FALSE,FALSE,"Lafayette Lever",77376,11,1982,1993
"2423",FALSE,FALSE,"Cliff Levingston",77377,12,1982,1994
"2424",FALSE,FALSE,"Bobby Lewis",77385,3,1967,1970
"2425",FALSE,FALSE,"Cedric Lewis",736,0,1995,1995
"2426",FALSE,FALSE,"Fred Lewis",77379,1,1948,1949
"2427",FALSE,FALSE,"Freddie Lewis",77380,10,1966,1976
"2428",FALSE,FALSE,"Grady Lewis",77381,2,1946,1948
"2429",FALSE,FALSE,"Martin Lewis",729,1,1995,1996
"2430",FALSE,FALSE,"Quincy Lewis",1900,4,1999,2003
"2431",FALSE,FALSE,"Ralph Lewis",77383,2,1987,1989
"2432",FALSE,FALSE,"Rashard Lewis",1740,15,1998,2013
"2433",FALSE,FALSE,"Reggie Lewis",77384,5,1987,1992
"2434",TRUE,TRUE,"Kira Lewis Jr.",1630184,0,2020,2020
"2435",FALSE,FALSE,"Marcus Liberty",77386,3,1990,1993
"2436",FALSE,FALSE,"Todd Lichti",77387,4,1989,1993
"2437",FALSE,FALSE,"DeAndre Liggins",202732,6,2011,2017
"2438",FALSE,FALSE,"Bill Ligon",77388,0,1974,1974
"2439",TRUE,FALSE,"Damian Lillard",203081,8,2012,2020
"2440",FALSE,FALSE,"Jeremy Lin",202391,8,2010,2018
"2441",FALSE,FALSE,"Steve Lingenfelter",77389,1,1982,1983
"2442",FALSE,FALSE,"Alton Lister",175,16,1981,1997
"2443",TRUE,FALSE,"Nassir Little",1629642,1,2019,2020
"2444",FALSE,FALSE,"Randy Livingston",988,10,1996,2006
"2445",FALSE,FALSE,"Shaun Livingston",2733,14,2004,2018
"2446",FALSE,FALSE,"Ron Livingstone",77392,1,1949,1950
"2447",FALSE,FALSE,"Horacio Llamas",1024,6,1996,2002
"2448",FALSE,FALSE,"Earl Lloyd",77394,9,1950,1959
"2449",FALSE,FALSE,"Lewis Lloyd",77395,8,1981,1989
"2450",FALSE,FALSE,"Scott Lloyd",77396,6,1976,1982
"2451",FALSE,FALSE,"Bob Lochmueller",77397,0,1952,1952
"2452",FALSE,FALSE,"Robert Lock",77398,0,1988,1988
"2453",FALSE,FALSE,"Darrell Lockhart",77399,0,1983,1983
"2454",FALSE,FALSE,"Ian Lockhart",1100,0,1990,1990
"2455",FALSE,FALSE,"Kevin Loder",77401,2,1981,1983
"2456",FALSE,FALSE,"Don Lofgran",77402,3,1950,1953
"2457",FALSE,FALSE,"Zach Lofton",1629155,0,2018,2018
"2458",FALSE,FALSE,"Johnny Logan",77403,4,1946,1950
"2459",FALSE,FALSE,"Brad Lohaus",38,10,1987,1997
"2460",FALSE,FALSE,"Art Long",1609,2,2000,2002
"2461",FALSE,FALSE,"Grant Long",3,14,1988,2002
"2462",FALSE,FALSE,"John Long",1381,18,1978,1996
"2463",FALSE,FALSE,"Paul Long",77406,3,1967,1970
"2464",FALSE,FALSE,"Shawn Long",1627848,0,2016,2016
"2465",FALSE,FALSE,"Luc Longley",26,9,1991,2000
"2466",TRUE,FALSE,"Kevon Looney",1626172,5,2015,2020
"2467",TRUE,FALSE,"Brook Lopez",201572,12,2008,2020
"2468",FALSE,FALSE,"Felipe Lopez",1732,4,1998,2002
"2469",FALSE,FALSE,"Raul Lopez",2221,2,2002,2004
"2470",TRUE,FALSE,"Robin Lopez",201577,12,2008,2020
"2471",FALSE,FALSE,"Ryan Lorthridge",943,0,1994,1994
"2472",FALSE,FALSE,"Jim Loscutoff",77409,8,1955,1963
"2473",FALSE,FALSE,"Plummer Lott",77410,1,1967,1968
"2474",FALSE,FALSE,"Kevin Loughery",77411,10,1962,1972
"2475",TRUE,TRUE,"Didi Louzada",1629712,0,2020,2020
"2476",FALSE,FALSE,"Bob Love",77412,10,1966,1976
"2477",TRUE,FALSE,"Kevin Love",201567,12,2008,2020
"2478",FALSE,FALSE,"Stan Love",77413,3,1971,1974
"2479",FALSE,FALSE,"Clyde Lovellette",77414,10,1953,1963
"2480",FALSE,FALSE,"Sidney Lowe",77415,6,1983,1989
"2481",FALSE,FALSE,"Chuck Lowery",77416,0,1971,1971
"2482",TRUE,FALSE,"Kyle Lowry",200768,14,2006,2020
"2483",FALSE,FALSE,"Jordan Loyd",1628070,0,2018,2018
"2484",FALSE,FALSE,"Al Lucas",77417,0,1948,1948
"2485",FALSE,FALSE,"Jerry Lucas",77418,10,1963,1973
"2486",FALSE,FALSE,"John Lucas",77419,13,1976,1989
"2487",FALSE,FALSE,"Kalin Lucas",203564,4,2014,2018
"2488",FALSE,FALSE,"Maurice Lucas",77420,11,1976,1987
"2489",FALSE,FALSE,"John Lucas III",101249,11,2005,2016
"2490",FALSE,FALSE,"Ted Luckenbill",77421,1,1961,1962
"2491",FALSE,FALSE,"Tyronn Lue",1731,10,1998,2008
"2492",FALSE,FALSE,"Jim Luisi",77422,0,1953,1953
"2493",FALSE,FALSE,"Al Lujack",77423,0,1946,1946
"2494",FALSE,FALSE,"Phil Lumpkin",77424,1,1974,1975
"2495",FALSE,FALSE,"Ray Lumpp",77425,4,1948,1952
"2496",TRUE,FALSE,"Timothe Luwawu-Cabarrot",1627789,4,2016,2020
"2497",FALSE,FALSE,"Tyler Lydon",1628399,1,2017,2018
"2498",TRUE,FALSE,"Trey Lyles",1626168,5,2015,2020
"2499",FALSE,FALSE,"George Lynch",248,11,1993,2004
"2500",FALSE,FALSE,"Kevin Lynch",77426,1,1991,1992
"2501",FALSE,FALSE,"Mike Lynn",77427,1,1969,1970
"2502",FALSE,FALSE,"Sheldon Mac",1627815,0,2016,2016
"2503",FALSE,FALSE,"Todd MacCulloch",1928,4,1999,2003
"2504",FALSE,FALSE,"Ronnie MacGilvray",77430,0,1954,1954
"2505",FALSE,FALSE,"Don MacLean",931,8,1992,2000
"2506",FALSE,FALSE,"Mike Macaluso",77428,0,1973,1973
"2507",FALSE,FALSE,"Ed Macauley",77429,9,1949,1958
"2508",FALSE,FALSE,"Scott Machado",203159,6,2012,2018
"2509",FALSE,FALSE,"Arvydas Macijauskas",101178,0,2005,2005
"2510",FALSE,FALSE,"Ollie Mack",77432,2,1979,1981
"2511",FALSE,FALSE,"Sam Mack",694,9,1992,2001
"2512",FALSE,FALSE,"Shelvin Mack",202714,7,2011,2018
"2513",FALSE,FALSE,"Malcolm Mackey",1635,0,1993,1993
"2514",FALSE,FALSE,"Rudy Macklin",77435,2,1981,1983
"2515",FALSE,FALSE,"Vernon Macklin",202731,0,2011,2011
"2516",FALSE,FALSE,"Johnny Macknowski",77436,1,1949,1950
"2517",FALSE,FALSE,"Daryl Macon",1629133,1,2018,2019
"2518",FALSE,FALSE,"Mark Macon",1855,7,1991,1998
"2519",FALSE,FALSE,"J.P. Macura",1629122,1,2018,2019
"2520",FALSE,FALSE,"Kyle Macy",77438,6,1980,1986
"2521",FALSE,FALSE,"Jack Maddox",77439,0,1948,1948
"2522",FALSE,FALSE,"Tito Maddox",2432,0,2002,2002
"2523",FALSE,FALSE,"Gerald Madkins",1666,4,1993,1997
"2524",FALSE,FALSE,"Mark Madsen",2058,8,2000,2008
"2525",FALSE,FALSE,"Norm Mager",77441,0,1950,1950
"2526",FALSE,FALSE,"Josh Magette",203705,2,2017,2019
"2527",FALSE,FALSE,"Corey Maggette",1894,13,1999,2012
"2528",FALSE,FALSE,"Dave Magley",77442,0,1982,1982
"2529",FALSE,FALSE,"Jamaal Magloire",2048,11,2000,2011
"2530",FALSE,TRUE,"Will Magnay",1630266,0,2020,2020
"2531",FALSE,FALSE,"Ian Mahinmi",101133,12,2007,2019
"2532",FALSE,FALSE,"John Mahnken",77443,6,1946,1952
"2533",FALSE,FALSE,"Francis Mahoney",77444,1,1952,1953
"2534",FALSE,FALSE,"Rick Mahorn",328,18,1980,1998
"2535",FALSE,FALSE,"Dan Majerle",105,13,1988,2001
"2536",FALSE,FALSE,"Renaldo Major",200970,0,2006,2006
"2537",FALSE,FALSE,"Thon Maker",1627748,4,2016,2020
"2538",FALSE,FALSE,"Lionel Malamed",77447,0,1948,1948
"2539",TRUE,TRUE,"Theo Maledon",1630177,0,2020,2020
"2540",FALSE,FALSE,"Jeff Malone",117,12,1983,1995
"2541",FALSE,FALSE,"Karl Malone",252,18,1985,2003
"2542",FALSE,FALSE,"Moses Malone",77449,18,1976,1994
"2543",FALSE,FALSE,"Matt Maloney",1074,6,1996,2002
"2544",FALSE,FALSE,"Steve Malovic",77450,0,1979,1979
"2545",FALSE,FALSE,"Ted Manakas",77451,0,1973,1973
"2546",FALSE,FALSE,"John Mandic",77452,1,1948,1949
"2547",FALSE,TRUE,"Karim Mane",1630211,0,2020,2020
"2548",FALSE,FALSE,"Frank Mangiapane",77453,0,1946,1946
"2549",FALSE,FALSE,"Marcus Mann",986,1,1996,1997
"2550",TRUE,FALSE,"Terance Mann",1629611,1,2019,2020
"2551",FALSE,FALSE,"Danny Manning",330,14,1988,2002
"2552",FALSE,FALSE,"Ed Manning",77454,3,1967,1970
"2553",FALSE,FALSE,"Richard Manning",316,1,1995,1996
"2554",TRUE,TRUE,"Nico Mannion",1630185,0,2020,2020
"2555",FALSE,FALSE,"Pace Mannion",77456,5,1983,1988
"2556",FALSE,FALSE,"Nick Mantis",77457,3,1959,1962
"2557",FALSE,FALSE,"Pete Maravich",77459,9,1970,1979
"2558",FALSE,FALSE,"Peter Maravich",77458,0,1946,1946
"2559",FALSE,FALSE,"Devyn Marble",203906,1,2014,2015
"2560",FALSE,FALSE,"Roy Marble",77460,4,1989,1993
"2561",FALSE,FALSE,"Stephon Marbury",950,12,1996,2008
"2562",FALSE,FALSE,"Sarunas Marciulionis",36,7,1989,1996
"2563",FALSE,FALSE,"Saul Mariaschin",77462,0,1947,1947
"2564",FALSE,FALSE,"Jack Marin",77463,10,1966,1976
"2565",FALSE,FALSE,"Shawn Marion",1890,15,1999,2014
"2566",TRUE,FALSE,"Boban Marjanovic",1626246,5,2015,2020
"2567",TRUE,FALSE,"Lauri Markkanen",1628374,3,2017,2020
"2568",FALSE,FALSE,"Damir Markota",200806,0,2006,2006
"2569",FALSE,FALSE,"Sean Marks",1752,12,1998,2010
"2570",FALSE,FALSE,"Harvey Marlatt",77464,2,1970,1972
"2571",FALSE,FALSE,"Eric Marsh",77465,0,1977,1977
"2572",FALSE,FALSE,"Jim Marsh",77466,0,1971,1971
"2573",FALSE,FALSE,"Donny Marshall",681,7,1995,2002
"2574",FALSE,FALSE,"Donyell Marshall",923,14,1994,2008
"2575",FALSE,FALSE,"Kendall Marshall",203088,3,2012,2015
"2576",TRUE,TRUE,"Naji Marshall",1630230,0,2020,2020
"2577",FALSE,FALSE,"Rawle Marshall",101185,1,2005,2006
"2578",FALSE,FALSE,"Tom Marshall",77467,4,1954,1958
"2579",FALSE,FALSE,"Vester Marshall",77468,0,1973,1973
"2580",FALSE,FALSE,"Bill Martin",77481,2,1985,1987
"2581",FALSE,FALSE,"Bob Martin",77478,1,1993,1994
"2582",FALSE,FALSE,"Brian Martin",77469,0,1985,1985
"2583",TRUE,FALSE,"Caleb Martin",1628997,1,2019,2020
"2584",FALSE,FALSE,"Cartier Martin",201858,6,2008,2014
"2585",TRUE,FALSE,"Cody Martin",1628998,1,2019,2020
"2586",FALSE,FALSE,"Cuonzo Martin",733,1,1995,1996
"2587",FALSE,FALSE,"Darrick Martin",239,13,1994,2007
"2588",FALSE,FALSE,"Don Martin",77473,2,1946,1948
"2589",FALSE,FALSE,"Donald Martin",77471,1,1946,1947
"2590",FALSE,FALSE,"Fernando Martin",77472,0,1986,1986
"2591",FALSE,FALSE,"Jarell Martin",1626185,3,2015,2018
"2592",FALSE,FALSE,"Jeff Martin",77474,1,1989,1990
"2593",TRUE,FALSE,"Jeremiah Martin",1629725,1,2019,2020
"2594",TRUE,FALSE,"Kelan Martin",1629103,1,2019,2020
"2595",FALSE,FALSE,"Kenyon Martin",2030,14,2000,2014
"2596",FALSE,FALSE,"Kevin Martin",2755,11,2004,2015
"2597",FALSE,FALSE,"Larue Martin",77475,3,1972,1975
"2598",FALSE,FALSE,"Mo Martin",77476,1,1986,1987
"2599",FALSE,FALSE,"Phil Martin",77477,0,1954,1954
"2600",FALSE,FALSE,"Ronald Martin",77479,0,1961,1961
"2601",FALSE,FALSE,"Slater Martin",77480,10,1949,1959
"2602",TRUE,TRUE,"Kenyon Martin Jr.",1630231,0,2020,2020
"2603",FALSE,FALSE,"Jamal Mashburn",469,10,1993,2003
"2604",FALSE,FALSE,"Al Masino",77482,1,1952,1953
"2605",FALSE,FALSE,"Anthony Mason",193,13,1989,2002
"2606",FALSE,FALSE,"Desmond Mason",2046,9,2000,2009
"2607",FALSE,FALSE,"Frank Mason",1628412,3,2017,2020
"2608",FALSE,FALSE,"Roger Mason Jr.",2427,11,2002,2013
"2609",FALSE,FALSE,"Tony Massenburg",763,14,1990,2004
"2610",FALSE,FALSE,"Eddie Mast",77483,2,1970,1972
"2611",FALSE,FALSE,"Yante Maten",1628999,0,2018,2018
"2612",TRUE,FALSE,"Garrison Mathews",1629726,1,2019,2020
"2613",FALSE,FALSE,"Mangok Mathiang",1628493,0,2017,2017
"2614",FALSE,TRUE,"Dakota Mathias",1629751,0,2020,2020
"2615",FALSE,FALSE,"Wes Matthews",77484,9,1980,1989
"2616",TRUE,FALSE,"Wesley Matthews",202083,11,2009,2020
"2617",FALSE,FALSE,"Ariel Maughan",77485,4,1946,1950
"2618",FALSE,FALSE,"Marlon Maxey",77486,1,1992,1993
"2619",TRUE,TRUE,"Tyrese Maxey",1630178,0,2020,2020
"2620",FALSE,FALSE,"Jason Maxiell",101131,9,2005,2014
"2621",FALSE,FALSE,"Cedric Maxwell",77487,10,1977,1987
"2622",FALSE,FALSE,"Vernon Maxwell",137,12,1988,2000
"2623",FALSE,FALSE,"Don May",77489,6,1968,1974
"2624",FALSE,FALSE,"Scott May",77490,6,1976,1982
"2625",FALSE,FALSE,"Sean May",101118,4,2005,2009
"2626",FALSE,FALSE,"Lee Mayberry",195,6,1992,1998
"2627",FALSE,FALSE,"Clyde Mayes",77492,1,1975,1976
"2628",FALSE,FALSE,"Tharon Mayes",77493,0,1991,1991
"2629",FALSE,FALSE,"Bill Mayfield",77495,0,1980,1980
"2630",FALSE,FALSE,"Ken Mayfield",77494,0,1975,1975
"2631",FALSE,FALSE,"Eric Maynor",201953,4,2009,2013
"2632",FALSE,FALSE,"O.J. Mayo",201564,7,2008,2015
"2633",TRUE,TRUE,"Skylar Mays",1630219,0,2020,2020
"2634",FALSE,FALSE,"Travis Mays",77496,2,1990,1992
"2635",FALSE,FALSE,"Matt Mazza",77497,0,1949,1949
"2636",FALSE,FALSE,"Luc Mbah a Moute",201601,11,2008,2019
"2637",FALSE,FALSE,"DJ Mbenga",2788,6,2004,2010
"2638",FALSE,FALSE,"Bob McAdoo",77498,13,1972,1985
"2639",FALSE,FALSE,"James Michael McAdoo",203949,3,2014,2017
"2640",FALSE,FALSE,"Ken McBride",77499,0,1954,1954
"2641",FALSE,FALSE,"Tahjere McCall",1628769,0,2018,2018
"2642",FALSE,FALSE,"Ray McCallum",203492,2,2013,2015
"2643",FALSE,FALSE,"Bob McCann",737,8,1989,1997
"2644",FALSE,FALSE,"Brendan McCann",77500,2,1957,1959
"2645",FALSE,FALSE,"Mel McCants",77502,0,1989,1989
"2646",FALSE,FALSE,"Rashad McCants",101119,3,2005,2008
"2647",FALSE,FALSE,"Mike McCarron",77503,3,1946,1949
"2648",FALSE,FALSE,"Andre McCarter",77504,4,1976,1980
"2649",FALSE,FALSE,"Willie McCarter",77505,2,1969,1971
"2650",FALSE,FALSE,"Johnny McCarthy",77506,7,1956,1963
"2651",FALSE,FALSE,"Howie McCarty",77507,0,1946,1946
"2652",FALSE,FALSE,"Kelly McCarty",1820,0,1998,1998
"2653",FALSE,FALSE,"Walter McCarty",962,9,1996,2005
"2654",FALSE,FALSE,"Amal McCaskill",1043,7,1996,2003
"2655",FALSE,FALSE,"Patrick McCaw",1627775,4,2016,2020
"2656",FALSE,FALSE,"Dwayne McClain",77509,0,1985,1985
"2657",FALSE,FALSE,"Ted, Hound Dog McClain",77510,2,1976,1978
"2658",FALSE,FALSE,"Dan McClintock",2082,0,2000,2000
"2659",FALSE,FALSE,"Jack McCloskey",77512,0,1952,1952
"2660",FALSE,FALSE,"George McCloud",45,13,1989,2002
"2661",TRUE,FALSE,"CJ McCollum",203468,7,2013,2020
"2662",FALSE,FALSE,"John McConathy",77513,0,1951,1951
"2663",FALSE,FALSE,"Paul McConnell",77514,0,1952,1952
"2664",TRUE,FALSE,"T.J. McConnell",204456,5,2015,2020
"2665",FALSE,FALSE,"Keith McCord",77515,0,1980,1980
"2666",FALSE,FALSE,"Tim McCormick",77516,7,1984,1991
"2667",FALSE,FALSE,"Jelani McCoy",1741,9,1998,2007
"2668",FALSE,FALSE,"Paul McCracken",77517,4,1972,1976
"2669",FALSE,FALSE,"Chris McCray",200840,0,2006,2006
"2670",FALSE,FALSE,"Rodney McCray",1622,9,1983,1992
"2671",FALSE,FALSE,"Scooter McCray",77518,3,1983,1986
"2672",FALSE,FALSE,"Erik McCree",1628571,0,2017,2017
"2673",FALSE,FALSE,"Chris McCullough",1626191,2,2015,2017
"2674",FALSE,FALSE,"John McCullough",77520,0,1981,1981
"2675",FALSE,FALSE,"Clint McDaniel",723,0,1995,1995
"2676",FALSE,FALSE,"Xavier McDaniel",1365,12,1985,1997
"2677",TRUE,TRUE,"Jaden McDaniels",1630183,0,2020,2020
"2678",TRUE,FALSE,"Jalen McDaniels",1629667,1,2019,2020
"2679",FALSE,FALSE,"Jim McDaniels",77523,6,1971,1977
"2680",FALSE,FALSE,"KJ McDaniels",203909,2,2014,2016
"2681",TRUE,FALSE,"Doug McDermott",203926,6,2014,2020
"2682",TRUE,TRUE,"Sean McDermott",1630253,0,2020,2020
"2683",FALSE,FALSE,"Ben McDonald",77524,3,1985,1988
"2684",FALSE,FALSE,"Glenn McDonald",77525,2,1974,1976
"2685",FALSE,FALSE,"Michael McDonald",1075,0,1997,1997
"2686",FALSE,FALSE,"Hank McDowell",77527,5,1981,1986
"2687",FALSE,FALSE,"Antonio McDyess",686,15,1995,2010
"2688",FALSE,FALSE,"Jim McElroy",77528,6,1975,1981
"2689",FALSE,FALSE,"Ivan McFarlin",200829,0,2006,2006
"2690",FALSE,FALSE,"Mel McGaha",77529,0,1948,1948
"2691",FALSE,FALSE,"Mitch McGary",203956,1,2014,2015
"2692",TRUE,FALSE,"JaVale McGee",201580,12,2008,2020
"2693",FALSE,FALSE,"Mike McGee",77530,8,1981,1989
"2694",FALSE,FALSE,"Bill McGill",77531,2,1962,1964
"2695",FALSE,FALSE,"George McGinnis",77532,6,1975,1981
"2696",FALSE,FALSE,"Jon McGlocklin",77533,10,1965,1975
"2697",FALSE,FALSE,"Tracy McGrady",1503,15,1997,2012
"2698",FALSE,FALSE,"Gil McGregor",77534,0,1971,1971
"2699",TRUE,FALSE,"Rodney McGruder",203585,4,2016,2020
"2700",FALSE,FALSE,"Al McGuire",77536,3,1951,1954
"2701",FALSE,FALSE,"Allie McGuire",77535,0,1973,1973
"2702",FALSE,FALSE,"Dick McGuire",77537,10,1949,1959
"2703",FALSE,FALSE,"Dominic McGuire",201187,5,2007,2012
"2704",FALSE,FALSE,"Kevin McHale",1450,12,1980,1992
"2705",FALSE,FALSE,"Jim McIlvaine",29,6,1994,2000
"2706",FALSE,FALSE,"Jeff McInnis",976,11,1996,2007
"2707",FALSE,FALSE,"Kenny McIntosh",77540,3,1971,1974
"2708",FALSE,FALSE,"Kevin McKenna",77541,6,1981,1987
"2709",FALSE,FALSE,"Forrest McKenzie",77542,0,1986,1986
"2710",FALSE,FALSE,"Stan McKenzie",77543,6,1967,1973
"2711",FALSE,FALSE,"Derrick McKey",365,14,1987,2001
"2712",FALSE,FALSE,"Aaron McKie",243,12,1994,2006
"2713",FALSE,FALSE,"Billy McKinney",77547,7,1978,1985
"2714",FALSE,FALSE,"Carlton McKinney",77545,2,1989,1991
"2715",FALSE,FALSE,"Horace McKinney",77546,5,1946,1951
"2716",FALSE,FALSE,"Trey McKinney-Jones",203590,0,2017,2017
"2717",TRUE,FALSE,"Alfonzo McKinnie",1628035,3,2017,2020
"2718",TRUE,FALSE,"Jordan McLaughlin",1629162,1,2019,2020
"2719",TRUE,FALSE,"Ben McLemore",203463,7,2013,2020
"2720",FALSE,FALSE,"Mccoy McLemore",77548,7,1964,1971
"2721",FALSE,FALSE,"George McLeod",77549,0,1952,1952
"2722",FALSE,FALSE,"Keith McLeod",2693,3,2003,2006
"2723",FALSE,FALSE,"Roshown McLeod",1728,2,1998,2000
"2724",FALSE,FALSE,"Jack McMahon",77551,7,1952,1959
"2725",FALSE,FALSE,"Nate McMillan",203,11,1986,1997
"2726",FALSE,FALSE,"Tom McMillen",77553,10,1975,1985
"2727",FALSE,FALSE,"Jim McMillian",77554,8,1970,1978
"2728",FALSE,FALSE,"Shellie McMillon",77555,3,1958,1961
"2729",FALSE,FALSE,"Mal McMullan",77556,1,1949,1950
"2730",FALSE,FALSE,"Chet McNabb",77557,0,1947,1947
"2731",FALSE,FALSE,"Mark McNamara",77558,8,1982,1990
"2732",FALSE,FALSE,"Joe McNamee",77559,1,1950,1951
"2733",FALSE,FALSE,"Jerel McNeal",202077,2,2012,2014
"2734",FALSE,FALSE,"Chris McNealy",77560,2,1985,1987
"2735",FALSE,FALSE,"Bob McNeill",77562,1,1960,1961
"2736",FALSE,FALSE,"Larry McNeill",77561,5,1973,1978
"2737",FALSE,FALSE,"Carl McNulty",77563,0,1954,1954
"2738",FALSE,FALSE,"Paul McPherson",2101,0,2000,2000
"2739",FALSE,FALSE,"Cozell McQueen",77565,0,1986,1986
"2740",FALSE,FALSE,"Jordan McRae",203895,4,2015,2019
"2741",FALSE,FALSE,"Thales McReynolds",77566,0,1965,1965
"2742",FALSE,FALSE,"Josh McRoberts",201177,10,2007,2017
"2743",FALSE,FALSE,"Eric McWilliams",77567,0,1972,1972
"2744",FALSE,FALSE,"George Mearns",77568,1,1946,1947
"2745",FALSE,FALSE,"Slava Medvedenko",2098,6,2000,2006
"2746",FALSE,FALSE,"Darnell Mee",1577,1,1993,1994
"2747",FALSE,FALSE,"Jodie Meeks",201975,9,2009,2018
"2748",FALSE,FALSE,"Cliff Meely",77570,4,1971,1975
"2749",FALSE,FALSE,"Scott Meents",77571,1,1989,1990
"2750",FALSE,FALSE,"Dick Mehen",77572,2,1949,1951
"2751",FALSE,FALSE,"Don Meineke",77573,5,1952,1957
"2752",FALSE,FALSE,"Carl Meinhold",77574,1,1947,1948
"2753",FALSE,FALSE,"Salah Mejri",1626257,3,2015,2018
"2754",FALSE,FALSE,"Gal Mekel",203539,1,2013,2014
"2755",FALSE,FALSE,"Bill Melchionni",77576,1,1966,1967
"2756",FALSE,FALSE,"Gary Melchionni",77575,1,1973,1974
"2757",TRUE,FALSE,"Nicolo Melli",1629740,1,2019,2020
"2758",FALSE,FALSE,"Fab Melo",203097,0,2012,2012
"2759",TRUE,FALSE,"De'Anthony Melton",1629001,2,2018,2020
"2760",FALSE,FALSE,"Ed Melvin",77577,0,1946,1946
"2761",FALSE,FALSE,"Dean Meminger",77578,5,1971,1976
"2762",FALSE,FALSE,"Chuck Mencel",77579,1,1955,1956
"2763",FALSE,FALSE,"John Mengelt",77580,9,1971,1980
"2764",FALSE,FALSE,"Ken Menke",77581,0,1949,1949
"2765",FALSE,FALSE,"Pops Mensah-Bonsu",200822,4,2006,2010
"2766",FALSE,FALSE,"Ron Mercer",1500,7,1997,2004
"2767",FALSE,FALSE,"Joe Meriweather",77582,9,1975,1984
"2768",FALSE,FALSE,"Porter Meriwether",77583,0,1962,1962
"2769",TRUE,TRUE,"Sam Merrill",1630241,0,2020,2020
"2770",FALSE,FALSE,"Tom Meschery",77584,9,1961,1970
"2771",TRUE,FALSE,"Chimezie Metu",1629002,2,2018,2020
"2772",FALSE,FALSE,"Loren Meyer",684,3,1995,1998
"2773",FALSE,FALSE,"Dave Meyers",77586,4,1975,1979
"2774",FALSE,FALSE,"Stan Miasek",77587,6,1946,1952
"2775",FALSE,FALSE,"Larry Micheaux",77588,1,1983,1984
"2776",FALSE,FALSE,"Jordan Mickey",1626175,2,2015,2017
"2777",TRUE,FALSE,"Khris Middleton",203114,8,2012,2020
"2778",FALSE,FALSE,"Zigmund Mihalik",77589,0,1946,1946
"2779",FALSE,FALSE,"Chris Mihm",2036,8,2000,2008
"2780",FALSE,FALSE,"Eric Mika",1628450,0,2019,2019
"2781",FALSE,FALSE,"Ed Mikan",77590,5,1948,1953
"2782",FALSE,FALSE,"George Mikan",600012,7,1948,1955
"2783",FALSE,FALSE,"Larry Mikan",77591,0,1970,1970
"2784",FALSE,FALSE,"Vern Mikkelsen",77593,9,1949,1958
"2785",FALSE,FALSE,"Al Miksis",77594,0,1949,1949
"2786",FALSE,FALSE,"Aaron Miles",101223,0,2005,2005
"2787",FALSE,FALSE,"CJ Miles",101139,14,2005,2019
"2788",FALSE,FALSE,"Darius Miles",2032,8,2000,2008
"2789",FALSE,FALSE,"Eddie Miles",77596,8,1963,1971
"2790",FALSE,FALSE,"Marko Milic",1527,1,1997,1998
"2791",FALSE,FALSE,"Darko Milicic",2545,9,2003,2012
"2792",FALSE,FALSE,"Nat Militzok",77598,0,1946,1946
"2793",FALSE,FALSE,"Andre Miller",1889,16,1999,2015
"2794",FALSE,FALSE,"Anthony Miller",292,10,1994,2004
"2795",FALSE,FALSE,"Bill Miller",77605,0,1948,1948
"2796",FALSE,FALSE,"Bob Miller",77603,0,1983,1983
"2797",FALSE,FALSE,"Brad Miller",1802,13,1998,2011
"2798",FALSE,FALSE,"Darius Miller",203121,8,2012,2020
"2799",FALSE,FALSE,"Dick Miller",77602,0,1980,1980
"2800",FALSE,FALSE,"Eddie Miller",77599,1,1952,1953
"2801",FALSE,FALSE,"Harry Miller",77600,0,1946,1946
"2802",FALSE,FALSE,"Jay Miller",77601,1,1967,1968
"2803",FALSE,FALSE,"Malcolm Miller",1626259,2,2017,2019
"2804",FALSE,FALSE,"Mike Miller",2034,16,2000,2016
"2805",FALSE,FALSE,"Oliver Miller",932,11,1992,2003
"2806",FALSE,FALSE,"Quincy Miller",203113,2,2012,2014
"2807",FALSE,FALSE,"Reggie Miller",397,17,1987,2004
"2808",FALSE,FALSE,"Walt Miller",77604,0,1946,1946
"2809",FALSE,FALSE,"Chris Mills",168,9,1993,2002
"2810",FALSE,FALSE,"John Mills",77606,0,1946,1946
"2811",TRUE,FALSE,"Patty Mills",201988,11,2009,2020
"2812",FALSE,FALSE,"Terry Mills",371,10,1990,2000
"2813",FALSE,FALSE,"Elijah Millsap",202407,2,2014,2016
"2814",TRUE,FALSE,"Paul Millsap",200794,14,2006,2020
"2815",TRUE,FALSE,"Shake Milton",1629003,2,2018,2020
"2816",FALSE,FALSE,"Harold Miner",114,3,1992,1995
"2817",FALSE,FALSE,"Dirk Minniefield",77609,2,1985,1987
"2818",FALSE,FALSE,"Dave Minor",77610,1,1951,1952
"2819",FALSE,FALSE,"Greg Minor",65,4,1994,1998
"2820",FALSE,FALSE,"Mark Minor",77612,0,1972,1972
"2821",FALSE,FALSE,"Nikola Mirotic",202703,4,2014,2018
"2822",FALSE,FALSE,"Wat Misaka",77613,0,1947,1947
"2823",FALSE,FALSE,"Jason Miskiri",1954,0,1999,1999
"2824",TRUE,FALSE,"Donovan Mitchell",1628378,3,2017,2020
"2825",FALSE,FALSE,"Mike Mitchell",77615,9,1978,1987
"2826",FALSE,FALSE,"Murray Mitchell",77616,0,1949,1949
"2827",FALSE,FALSE,"Sam Mitchell",417,12,1989,2001
"2828",FALSE,FALSE,"Todd Mitchell",77614,0,1988,1988
"2829",FALSE,FALSE,"Tony Mitchell",203183,0,2013,2013
"2830",FALSE,FALSE,"Tony Mitchell",203502,0,2013,2013
"2831",FALSE,FALSE,"Naz Mitrou-Long",1628513,2,2017,2019
"2832",FALSE,FALSE,"Steve Mix",77618,13,1969,1982
"2833",FALSE,FALSE,"Bill Mlkvy",77619,0,1952,1952
"2834",FALSE,FALSE,"Cuttino Mobley",1749,10,1998,2008
"2835",FALSE,FALSE,"Eric Mobley",211,2,1994,1996
"2836",FALSE,FALSE,"Larry Moffett",77621,0,1977,1977
"2837",FALSE,FALSE,"Leo Mogus",77622,4,1946,1950
"2838",FALSE,FALSE,"Nazr Mohammed",1737,17,1998,2015
"2839",FALSE,FALSE,"Jerome Moiso",2040,4,2000,2004
"2840",FALSE,FALSE,"Paul Mokeski",77623,11,1979,1990
"2841",TRUE,FALSE,"Adam Mokoka",1629690,1,2019,2020
"2842",FALSE,FALSE,"Jack Molinas",77624,0,1953,1953
"2843",FALSE,FALSE,"Wayne Molis",77625,0,1966,1966
"2844",FALSE,FALSE,"Sidney Moncrief",77626,11,1979,1990
"2845",FALSE,FALSE,"Eric Money",77627,5,1974,1979
"2846",FALSE,FALSE,"Sergei Monia",2752,0,2005,2005
"2847",TRUE,FALSE,"Malik Monk",1628370,3,2017,2020
"2848",FALSE,FALSE,"Earl Monroe",600006,12,1967,1979
"2849",FALSE,FALSE,"Greg Monroe",202328,8,2010,2018
"2850",FALSE,FALSE,"Rodney Monroe",77628,0,1991,1991
"2851",FALSE,FALSE,"Luis Montero",1626242,2,2015,2017
"2852",FALSE,FALSE,"Howie Montgomery",77630,0,1962,1962
"2853",FALSE,FALSE,"Eric Montross",376,8,1994,2002
"2854",FALSE,FALSE,"Jamario Moon",200081,4,2007,2011
"2855",FALSE,FALSE,"Jim Mooney",77631,0,1952,1952
"2856",FALSE,FALSE,"Matt Mooney",1629760,0,2019,2019
"2857",FALSE,FALSE,"Andre Moore",77632,0,1987,1987
"2858",FALSE,FALSE,"Ben Moore",1628500,1,2017,2018
"2859",TRUE,FALSE,"E'Twaun Moore",202734,9,2011,2020
"2860",FALSE,FALSE,"Jackie Moore",77634,2,1954,1956
"2861",FALSE,FALSE,"Johnny Moore",77633,9,1980,1989
"2862",FALSE,FALSE,"Lowes Moore",77635,2,1980,1982
"2863",FALSE,FALSE,"Mikki Moore",1630,13,1998,2011
"2864",FALSE,FALSE,"Otto Moore",77636,8,1968,1976
"2865",FALSE,FALSE,"Ron Moore",77637,0,1987,1987
"2866",FALSE,FALSE,"Tracy Moore",929,5,1991,1996
"2867",TRUE,FALSE,"Ja Morant",1629630,1,2019,2020
"2868",FALSE,FALSE,"Eric Moreland",203961,4,2014,2018
"2869",FALSE,FALSE,"Jackie Moreland",77639,4,1960,1964
"2870",FALSE,FALSE,"Guy Morgan",77640,0,1982,1982
"2871",TRUE,FALSE,"Juwan Morgan",1629752,1,2019,2020
"2872",FALSE,FALSE,"Rex Morgan",77641,1,1970,1971
"2873",FALSE,FALSE,"Elmo Morgenthaler",77642,2,1946,1948
"2874",FALSE,FALSE,"Darren Morningstar",77644,0,1993,1993
"2875",FALSE,FALSE,"Chris Morris",356,10,1988,1998
"2876",FALSE,FALSE,"Darius Morris",202721,3,2011,2014
"2877",FALSE,FALSE,"Isaiah Morris",77647,0,1992,1992
"2878",FALSE,FALSE,"Jaylen Morris",1628537,1,2017,2018
"2879",TRUE,FALSE,"Markieff Morris",202693,9,2011,2020
"2880",FALSE,FALSE,"Max Morris",77646,0,1949,1949
"2881",TRUE,FALSE,"Monte Morris",1628420,3,2017,2020
"2882",FALSE,FALSE,"Randolph Morris",201043,3,2006,2009
"2883",FALSE,FALSE,"Terence Morris",2242,4,2001,2005
"2884",TRUE,FALSE,"Marcus Morris Sr.",202694,9,2011,2020
"2885",FALSE,FALSE,"Adam Morrison",200747,3,2006,2009
"2886",FALSE,FALSE,"Dwight Morrison",77648,3,1954,1957
"2887",FALSE,FALSE,"Mike Morrison",77649,0,1989,1989
"2888",FALSE,FALSE,"Anthony Morrow",201627,8,2008,2016
"2889",FALSE,FALSE,"Dwayne Morton",132,0,1994,1994
"2890",FALSE,FALSE,"John Morton",1972,2,1989,1991
"2891",FALSE,FALSE,"Richard Morton",77652,0,1988,1988
"2892",FALSE,FALSE,"Glenn Mosley",77653,1,1977,1978
"2893",FALSE,FALSE,"Perry Moss",77654,1,1985,1986
"2894",FALSE,FALSE,"Lawrence Moten",734,2,1995,1997
"2895",FALSE,FALSE,"Donatas Motiejunas",202700,6,2012,2018
"2896",FALSE,FALSE,"Johnathan Motley",1628405,2,2017,2019
"2897",FALSE,FALSE,"Hanno Mottola",2069,1,2000,2001
"2898",FALSE,FALSE,"Arnett Moultrie",203102,1,2012,2013
"2899",FALSE,FALSE,"Alonzo Mourning",297,15,1992,2007
"2900",FALSE,FALSE,"Timofey Mozgov",202389,8,2010,2018
"2901",FALSE,FALSE,"Chuck Mrazovich",77657,0,1950,1950
"2902",FALSE,FALSE,"Emmanuel Mudiay",1626144,4,2015,2019
"2903",FALSE,FALSE,"Erwin Mueller",77658,6,1966,1972
"2904",FALSE,FALSE,"Shabazz Muhammad",203498,4,2013,2017
"2905",TRUE,FALSE,"Mychal Mulder",1628539,1,2019,2020
"2906",FALSE,FALSE,"Joe Mullaney",77659,0,1949,1949
"2907",FALSE,FALSE,"Bob Mullens",77660,0,1946,1946
"2908",FALSE,FALSE,"Byron Mullens",201957,4,2009,2013
"2909",FALSE,FALSE,"Chris Mullin",904,15,1985,2000
"2910",FALSE,FALSE,"Jeff Mullins",77662,11,1964,1975
"2911",FALSE,FALSE,"Todd Mundt",942,0,1995,1995
"2912",FALSE,FALSE,"Xavier Munford",204098,2,2015,2017
"2913",FALSE,FALSE,"Chris Munk",77664,0,1990,1990
"2914",FALSE,FALSE,"George Munroe",77665,1,1946,1947
"2915",FALSE,FALSE,"Eric Murdock",785,8,1991,1999
"2916",FALSE,FALSE,"Gheorghe Muresan",49,6,1993,1999
"2917",FALSE,FALSE,"Allen Murphy",77668,0,1976,1976
"2918",FALSE,FALSE,"Calvin Murphy",77669,12,1970,1982
"2919",FALSE,FALSE,"Dick Murphy",77672,0,1946,1946
"2920",FALSE,FALSE,"Erik Murphy",203513,0,2013,2013
"2921",FALSE,FALSE,"Jay Murphy",77670,3,1984,1987
"2922",FALSE,FALSE,"John Murphy",77671,0,1946,1946
"2923",FALSE,FALSE,"Kevin Murphy",203122,0,2012,2012
"2924",FALSE,FALSE,"Ronnie Murphy",77673,0,1987,1987
"2925",FALSE,FALSE,"Tod Murphy",77674,6,1987,1993
"2926",FALSE,FALSE,"Troy Murphy",2211,11,2001,2012
"2927",TRUE,FALSE,"Dejounte Murray",1627749,4,2016,2020
"2928",FALSE,FALSE,"Flip Murray",2436,7,2002,2009
"2929",TRUE,FALSE,"Jamal Murray",1627750,4,2016,2020
"2930",FALSE,FALSE,"Ken Murray",77675,4,1950,1954
"2931",FALSE,FALSE,"Lamond Murray",441,11,1994,2005
"2932",FALSE,FALSE,"Tracy Murray",145,11,1992,2003
"2933",FALSE,FALSE,"Dorie Murrey",77676,5,1966,1971
"2934",FALSE,FALSE,"Toure' Murry",203315,1,2013,2014
"2935",FALSE,FALSE,"Dzanan Musa",1629058,1,2018,2019
"2936",TRUE,FALSE,"Mike Muscala",203488,7,2013,2020
"2937",FALSE,FALSE,"Angelo Musi",77677,2,1946,1948
"2938",FALSE,FALSE,"Jerrod Mustaf",1054,3,1990,1993
"2939",FALSE,FALSE,"Dikembe Mutombo",87,17,1991,2008
"2940",FALSE,FALSE,"Martin Muursepp",982,1,1996,1997
"2941",FALSE,FALSE,"Pete Myers",939,11,1986,1997
"2942",TRUE,FALSE,"Svi Mykhailiuk",1629004,2,2018,2020
"2943",FALSE,FALSE,"Makhtar N'diaye",1823,0,1998,1998
"2944",FALSE,FALSE,"Makhtar N'diaye",1626122,0,1998,1998
"2945",FALSE,FALSE,"Mamadou N'diaye",2055,4,2000,2004
"2946",FALSE,FALSE,"Bob Naber",77681,0,1952,1952
"2947",FALSE,FALSE,"Boris Nachamkin",77682,0,1954,1954
"2948",FALSE,FALSE,"Bostjan Nachbar",2411,5,2002,2007
"2949",TRUE,FALSE,"Abdel Nader",1627846,3,2017,2020
"2950",FALSE,FALSE,"Jerry Nagel",77683,0,1949,1949
"2951",FALSE,FALSE,"Fred Nagy",77684,0,1948,1948
"2952",FALSE,FALSE,"Lee Nailon",1924,5,2000,2005
"2953",FALSE,FALSE,"Eduardo Najera",2059,11,2000,2011
"2954",FALSE,FALSE,"Larry Nance",77685,12,1981,1993
"2955",TRUE,FALSE,"Larry Nance Jr.",1626204,5,2015,2020
"2956",FALSE,FALSE,"Shabazz Napier",203894,5,2014,2019
"2957",FALSE,FALSE,"Paul Napolitano",77686,0,1948,1948
"2958",FALSE,FALSE,"Bob Nash",77688,6,1972,1978
"2959",FALSE,FALSE,"Charles Nash",77687,0,1964,1964
"2960",FALSE,FALSE,"Steve Nash",959,17,1996,2013
"2961",FALSE,FALSE,"Swen Nater",77689,7,1976,1983
"2962",FALSE,FALSE,"Howard Nathan",77690,0,1995,1995
"2963",FALSE,FALSE,"Calvin Natt",77691,10,1979,1989
"2964",FALSE,FALSE,"Kenny Natt",77692,4,1980,1984
"2965",FALSE,FALSE,"Willie Naulls",77693,9,1956,1965
"2966",FALSE,FALSE,"Juan Carlos Navarro",2434,0,2007,2007
"2967",FALSE,FALSE,"Hamady Ndiaye",202380,3,2010,2013
"2968",FALSE,FALSE,"Boniface Ndong",101238,0,2005,2005
"2969",FALSE,FALSE,"Maurice Ndour",1626254,0,2016,2016
"2970",FALSE,FALSE,"Craig Neal",77694,2,1988,1990
"2971",FALSE,FALSE,"Gary Neal",202390,6,2010,2016
"2972",FALSE,FALSE,"Jim Neal",77695,1,1953,1954
"2973",FALSE,FALSE,"Lloyd Neal",77696,6,1972,1978
"2974",FALSE,FALSE,"Ed Nealy",77697,10,1982,1992
"2975",FALSE,FALSE,"Nemanja Nedovic",203517,0,2013,2013
"2976",FALSE,FALSE,"Al Negratti",77698,0,1946,1946
"2977",FALSE,FALSE,"Barry Nelson",77699,0,1971,1971
"2978",FALSE,FALSE,"DeMarcus Nelson",201634,0,2008,2008
"2979",FALSE,FALSE,"Don Nelson",77700,13,1962,1975
"2980",FALSE,FALSE,"Jameer Nelson",2749,13,2004,2017
"2981",FALSE,FALSE,"Louie Nelson",77701,4,1973,1977
"2982",FALSE,FALSE,"Ruben Nembhard",1129,0,1996,1996
"2983",FALSE,FALSE,"Tyrone Nesby",1838,3,1998,2001
"2984",TRUE,TRUE,"Aaron Nesmith",1630174,0,2020,2020
"2985",FALSE,FALSE,"Martin Nessley",77704,0,1987,1987
"2986",FALSE,FALSE,"Rasho Nesterovic",1725,11,1998,2009
"2987",TRUE,FALSE,"Raul Neto",203526,5,2015,2020
"2988",FALSE,FALSE,"Johnny Neumann",77705,1,1976,1977
"2989",FALSE,FALSE,"Paul Neumann",77706,5,1961,1966
"2990",FALSE,FALSE,"Chuck Nevitt",77707,11,1982,1993
"2991",FALSE,FALSE,"Melvin Newbern",1116,0,1992,1992
"2992",FALSE,FALSE,"Ivano Newbill",1096,3,1994,1997
"2993",FALSE,FALSE,"Ira Newble",1956,7,2000,2007
"2994",FALSE,FALSE,"Mike Newlin",77710,10,1971,1981
"2995",FALSE,FALSE,"Johnny Newman",271,15,1986,2001
"2996",FALSE,FALSE,"Malik Newman",1629005,0,2019,2019
"2997",FALSE,FALSE,"Dave Newmark",77712,1,1968,1969
"2998",TRUE,FALSE,"Georges Niang",1627777,4,2016,2020
"2999",FALSE,FALSE,"Demetris Nichols",201193,1,2007,2008
"3000",FALSE,FALSE,"Jack Nichols",77713,9,1948,1957
"3001",FALSE,FALSE,"Andrew Nicholson",203094,4,2012,2016
"3002",FALSE,FALSE,"Gaylon Nickerson",1093,0,1996,1996
"3003",FALSE,FALSE,"Carl Nicks",77715,2,1980,1982
"3004",FALSE,FALSE,"Rich Niemann",77716,1,1968,1969
"3005",FALSE,FALSE,"John Niemiera",77717,1,1948,1949
"3006",FALSE,FALSE,"Mike Niles",77718,0,1980,1980
"3007",FALSE,FALSE,"Kurt Nimphius",77719,8,1981,1989
"3008",FALSE,FALSE,"Dyron Nix",77720,0,1989,1989
"3009",FALSE,FALSE,"Norm Nixon",77721,11,1977,1988
"3010",TRUE,TRUE,"Zeke Nnaji",1630192,0,2020,2020
"3011",FALSE,FALSE,"Joakim Noah",201149,12,2007,2019
"3012",FALSE,FALSE,"Chuck Noble",77722,6,1955,1961
"3013",FALSE,FALSE,"Andres Nocioni",2804,7,2004,2011
"3014",FALSE,FALSE,"David Noel",200786,0,2006,2006
"3015",TRUE,FALSE,"Nerlens Noel",203457,7,2013,2020
"3016",FALSE,FALSE,"Paul Noel",77723,4,1947,1951
"3017",FALSE,FALSE,"Lucas Nogueira",203512,3,2014,2017
"3018",FALSE,FALSE,"Jim Nolan",77724,0,1949,1949
"3019",FALSE,FALSE,"Paul Nolen",77725,0,1953,1953
"3020",FALSE,FALSE,"Jeff Nordgaard",999,0,1997,1997
"3021",FALSE,FALSE,"Robert Nordmann",77727,3,1961,1964
"3022",FALSE,FALSE,"Johnny Norlander",77728,4,1946,1950
"3023",FALSE,FALSE,"Connie Norman",77729,4,1974,1978
"3024",FALSE,FALSE,"Ken Norman",80,9,1987,1996
"3025",FALSE,FALSE,"Audie Norris",77731,2,1982,1984
"3026",FALSE,FALSE,"Moochie Norris",983,9,1996,2005
"3027",FALSE,FALSE,"Sylvester Norris",77732,0,1979,1979
"3028",FALSE,FALSE,"Zach Norvell Jr.",1629668,0,2019,2019
"3029",FALSE,FALSE,"Willie Norwood",77733,6,1971,1977
"3030",FALSE,FALSE,"George Nostrand",77734,3,1946,1949
"3031",FALSE,FALSE,"Stan Noszka",77735,2,1946,1948
"3032",FALSE,FALSE,"Mike Novak",77736,5,1948,1953
"3033",FALSE,FALSE,"Steve Novak",200779,10,2006,2016
"3034",TRUE,FALSE,"Jaylen Nowell",1629669,1,2019,2020
"3035",FALSE,FALSE,"Mel Nowell",77737,0,1962,1962
"3036",FALSE,FALSE,"Dirk Nowitzki",1717,20,1998,2018
"3037",TRUE,FALSE,"Frank Ntilikina",1628373,3,2017,2020
"3038",TRUE,FALSE,"Kendrick Nunn",1629134,2,2018,2020
"3039",TRUE,FALSE,"James Nunnally",203263,7,2013,2020
"3040",TRUE,FALSE,"Jusuf Nurkic",203994,6,2014,2020
"3041",FALSE,FALSE,"Dennis Nutt",77738,0,1986,1986
"3042",TRUE,FALSE,"David Nwaba",1628021,4,2016,2020
"3043",TRUE,TRUE,"Jordan Nwora",1629670,0,2020,2020
"3044",FALSE,FALSE,"Julius Nwosu",1022,0,1994,1994
"3045",FALSE,FALSE,"Charles O'Bannon",1525,1,1997,1998
"3046",FALSE,FALSE,"Ed O'Bannon",709,1,1995,1996
"3047",FALSE,FALSE,"John O'Boyle",77742,0,1952,1952
"3048",FALSE,FALSE,"Bob O'Brien",77744,1,1947,1948
"3049",FALSE,FALSE,"Buckshot O'Brien",77743,1,1951,1952
"3050",FALSE,FALSE,"JJ O'Brien",1626266,0,2015,2015
"3051",FALSE,FALSE,"Patrick O'Bryant",200753,3,2006,2009
"3052",FALSE,FALSE,"Johnny O'Bryant III",203948,3,2014,2017
"3053",FALSE,FALSE,"Dermie O'Connell",77745,1,1948,1949
"3054",FALSE,FALSE,"Andy O'Donnell",77746,0,1949,1949
"3055",FALSE,FALSE,"Francis O'Grady",77750,2,1946,1948
"3056",FALSE,FALSE,"Dick O'Keefe",77752,3,1947,1950
"3057",FALSE,FALSE,"Tommy O'Keefe",77753,0,1950,1950
"3058",FALSE,FALSE,"Mike O'Koren",77754,7,1980,1987
"3059",FALSE,FALSE,"Grady O'Malley",77766,0,1969,1969
"3060",FALSE,FALSE,"Jermaine O'Neal",979,17,1996,2013
"3061",FALSE,FALSE,"Shaquille O'Neal",406,18,1992,2010
"3062",TRUE,FALSE,"Royce O'Neale",1626220,3,2017,2020
"3063",FALSE,FALSE,"Mike O'Neill",77767,0,1952,1952
"3064",FALSE,FALSE,"Kyle O'Quinn",203124,7,2012,2019
"3065",FALSE,FALSE,"Kevin O'Shea",77773,2,1950,1952
"3066",FALSE,FALSE,"Garland O'Shields",77774,0,1946,1946
"3067",FALSE,FALSE,"Dan O'Sullivan",77776,5,1990,1995
"3068",FALSE,FALSE,"Charles Oakley",891,18,1985,2003
"3069",FALSE,FALSE,"Fabricio Oberto",101177,5,2005,2010
"3070",FALSE,FALSE,"Daniel Ochefu",1627849,0,2016,2016
"3071",FALSE,FALSE,"Greg Oden",201141,6,2007,2013
"3072",FALSE,FALSE,"Lamar Odom",1885,14,1999,2013
"3073",FALSE,FALSE,"Carlos Ogden",77747,1,1969,1970
"3074",FALSE,FALSE,"Ralph Ogden",77748,0,1970,1970
"3075",FALSE,FALSE,"Alan Ogg",1628,2,1990,1992
"3076",FALSE,FALSE,"Don Ohl",77751,9,1960,1969
"3077",FALSE,FALSE,"Tim Ohlbrecht",203317,0,2012,2012
"3078",TRUE,FALSE,"Semi Ojeleye",1628400,3,2017,2020
"3079",FALSE,FALSE,"Emeka Okafor",2731,13,2004,2017
"3080",TRUE,FALSE,"Jahlil Okafor",1626143,5,2015,2020
"3081",TRUE,TRUE,"Chuma Okeke",1629643,0,2020,2020
"3082",FALSE,FALSE,"Elie Okobo",1629059,1,2018,2019
"3083",TRUE,FALSE,"Josh Okogie",1629006,2,2018,2020
"3084",TRUE,TRUE,"Onyeka Okongwu",1630168,0,2020,2020
"3085",TRUE,TRUE,"Isaac Okoro",1630171,0,2020,2020
"3086",TRUE,FALSE,"KZ Okpala",1629644,1,2019,2020
"3087",FALSE,FALSE,"Mehmet Okur",2246,9,2002,2011
"3088",TRUE,FALSE,"Victor Oladipo",203506,7,2013,2020
"3089",FALSE,FALSE,"Hakeem Olajuwon",165,18,1984,2002
"3090",FALSE,FALSE,"Mark Olberding",77756,10,1976,1986
"3091",FALSE,FALSE,"Jawann Oldham",77757,10,1980,1990
"3092",FALSE,FALSE,"Johnny Oldham",77758,1,1949,1950
"3093",FALSE,FALSE,"Frank Oleynick",77759,1,1975,1976
"3094",FALSE,FALSE,"John Olive",77760,1,1978,1979
"3095",FALSE,FALSE,"Brian Oliver",1680,7,1990,1997
"3096",FALSE,TRUE,"Cameron Oliver",1628419,0,2020,2020
"3097",FALSE,FALSE,"Dean Oliver",2352,1,2001,2002
"3098",FALSE,FALSE,"Jimmy Oliver",1429,7,1991,1998
"3099",FALSE,FALSE,"Kevin Ollie",1563,12,1997,2009
"3100",FALSE,FALSE,"Gene Ollrich",77764,0,1949,1949
"3101",FALSE,FALSE,"Michael Olowokandi",1709,8,1998,2006
"3102",FALSE,FALSE,"Enoch Olsen",77765,6,1962,1968
"3103",TRUE,FALSE,"Kelly Olynyk",203482,7,2013,2020
"3104",TRUE,FALSE,"Miye Oni",1629671,1,2019,2020
"3105",FALSE,FALSE,"Arinze Onuaku",202620,3,2013,2016
"3106",FALSE,FALSE,"Chinanu Onuaku",1627778,1,2016,2017
"3107",FALSE,FALSE,"Barry Orms",77768,0,1968,1968
"3108",FALSE,FALSE,"Johnny Orr",77769,0,1949,1949
"3109",FALSE,FALSE,"Louis Orr",77770,7,1980,1987
"3110",FALSE,FALSE,"Jose Ortiz",77771,1,1988,1989
"3111",FALSE,FALSE,"Daniel Orton",202350,3,2010,2013
"3112",FALSE,FALSE,"Chuck Osborne",77772,0,1961,1961
"3113",TRUE,FALSE,"Cedi Osman",1626224,3,2017,2020
"3114",FALSE,FALSE,"Wally Osterkorn",77775,3,1951,1954
"3115",FALSE,FALSE,"Greg Ostertag",731,10,1995,2005
"3116",FALSE,FALSE,"Matt Othick",77777,0,1992,1992
"3117",FALSE,FALSE,"Don Otten",77778,3,1949,1952
"3118",FALSE,FALSE,"Mac Otten",77779,0,1949,1949
"3119",TRUE,TRUE,"Daniel Oturu",1630187,0,2020,2020
"3120",TRUE,FALSE,"Kelly Oubre Jr.",1626162,5,2015,2020
"3121",FALSE,FALSE,"Bo Outlaw",448,14,1993,2007
"3122",FALSE,FALSE,"Travis Outlaw",2566,10,2003,2013
"3123",FALSE,FALSE,"Claude Overton",77780,0,1952,1952
"3124",FALSE,FALSE,"Doug Overton",77,11,1992,2003
"3125",FALSE,FALSE,"Andre Owens",101261,2,2005,2007
"3126",FALSE,FALSE,"Billy Owens",182,11,1991,2002
"3127",FALSE,FALSE,"Chris Owens",2442,0,2002,2002
"3128",FALSE,FALSE,"Eddie Owens",77782,0,1977,1977
"3129",FALSE,FALSE,"James Owens",77783,2,1949,1951
"3130",FALSE,FALSE,"Jim Owens",77784,1,1973,1974
"3131",FALSE,FALSE,"Keith Owens",77785,0,1991,1991
"3132",FALSE,FALSE,"Larry Owens",202082,1,2010,2011
"3133",FALSE,FALSE,"Tariq Owens",1629745,0,2019,2019
"3134",FALSE,FALSE,"Tom Owens",77786,6,1976,1982
"3135",FALSE,FALSE,"Ray Owes",1077,0,1996,1996
"3136",FALSE,FALSE,"Olumide Oyedeji",2071,2,2000,2002
"3137",FALSE,FALSE,"Joe Pace",77788,1,1976,1977
"3138",FALSE,FALSE,"Zaza Pachulia",2585,15,2003,2018
"3139",FALSE,FALSE,"Robert Pack",123,12,1991,2003
"3140",FALSE,FALSE,"Gerald Paddio",77789,3,1990,1993
"3141",FALSE,FALSE,"Scott Padgett",1909,7,1999,2006
"3142",FALSE,FALSE,"Marcus Paige",1627779,0,2017,2017
"3143",FALSE,FALSE,"Fred Paine",77790,0,1948,1948
"3144",FALSE,FALSE,"Milt Palacio",1960,6,1999,2005
"3145",FALSE,FALSE,"Togo Palazzi",77791,5,1954,1959
"3146",FALSE,FALSE,"Jim Palmer",77792,2,1958,1960
"3147",FALSE,FALSE,"John Palmer",77793,2,1946,1948
"3148",FALSE,FALSE,"Walter Palmer",77794,2,1990,1992
"3149",FALSE,FALSE,"Andy Panko",1950,0,2000,2000
"3150",FALSE,FALSE,"Georgios Papagiannis",1627834,1,2016,2017
"3151",FALSE,FALSE,"Kostas Papanikolaou",203123,1,2014,2015
"3152",FALSE,FALSE,"Jannero Pargo",2457,12,2002,2014
"3153",FALSE,FALSE,"Jeremy Pargo",202951,8,2011,2019
"3154",FALSE,FALSE,"Estes Parham",77797,2,1948,1950
"3155",FALSE,FALSE,"Robert Parish",305,20,1976,1996
"3156",FALSE,FALSE,"Medford Park",77799,4,1955,1959
"3157",FALSE,FALSE,"Anthony Parker",1515,14,1997,2011
"3158",TRUE,FALSE,"Jabari Parker",203953,6,2014,2020
"3159",FALSE,FALSE,"Smush Parker",2470,5,2002,2007
"3160",FALSE,FALSE,"Sonny Parker",77800,5,1976,1981
"3161",FALSE,FALSE,"Tony Parker",2225,17,2001,2018
"3162",FALSE,FALSE,"Jack Parkinson",77801,0,1949,1949
"3163",FALSE,FALSE,"Cherokee Parks",685,8,1995,2003
"3164",FALSE,FALSE,"Jack Parr",77802,0,1958,1958
"3165",FALSE,FALSE,"Doyle Parrack",77803,0,1946,1946
"3166",FALSE,FALSE,"Charlie Parsley",77804,0,1949,1949
"3167",FALSE,FALSE,"Chandler Parsons",202718,8,2011,2019
"3168",TRUE,FALSE,"Eric Paschall",1629672,1,2019,2020
"3169",FALSE,FALSE,"Anzejs Pasecniks",1628394,1,2019,2020
"3170",FALSE,FALSE,"Zarko Paspalj",1097,0,1989,1989
"3171",FALSE,FALSE,"Marty Passaglia",77806,2,1946,1948
"3172",FALSE,FALSE,"George A. Pastushok",77807,0,1946,1946
"3173",FALSE,FALSE,"Myles Patrick",77808,0,1980,1980
"3174",FALSE,FALSE,"Stan Patrick",77809,0,1949,1949
"3175",FALSE,FALSE,"Andrae Patterson",1754,1,1998,1999
"3176",FALSE,FALSE,"George Patterson",77811,0,1967,1967
"3177",FALSE,FALSE,"Lamar Patterson",203934,1,2015,2016
"3178",TRUE,FALSE,"Patrick Patterson",202335,10,2010,2020
"3179",FALSE,FALSE,"Ruben Patterson",1739,9,1998,2007
"3180",FALSE,FALSE,"Steve Patterson",77812,4,1971,1975
"3181",FALSE,FALSE,"Tommy Patterson",77813,1,1972,1973
"3182",FALSE,FALSE,"Worthy Patterson",77814,0,1957,1957
"3183",FALSE,FALSE,"Justin Patton",1628383,3,2017,2020
"3184",FALSE,FALSE,"Brandon Paul",203464,0,2017,2017
"3185",TRUE,FALSE,"Chris Paul",101108,15,2005,2020
"3186",FALSE,FALSE,"Charlie Paulk",77815,3,1968,1971
"3187",FALSE,FALSE,"Jerry Paulson",77816,0,1957,1957
"3188",FALSE,FALSE,"Billy Paultz",77817,8,1976,1984
"3189",FALSE,FALSE,"Sasha Pavlovic",2562,9,2003,2012
"3190",FALSE,FALSE,"Jim Paxson",77818,1,1956,1957
"3191",FALSE,FALSE,"Jim Paxson",77819,10,1979,1989
"3192",FALSE,FALSE,"John Paxson",77820,10,1983,1993
"3193",FALSE,FALSE,"Johnny Payak",77821,3,1949,1952
"3194",FALSE,FALSE,"Adreian Payne",203940,3,2014,2017
"3195",TRUE,FALSE,"Cameron Payne",1626166,5,2015,2020
"3196",FALSE,FALSE,"Kenny Payne",77822,3,1989,1992
"3197",FALSE,FALSE,"Tom Payne",77823,0,1971,1971
"3198",TRUE,FALSE,"Elfrid Payton",203901,6,2014,2020
"3199",FALSE,FALSE,"Gary Payton",56,16,1990,2006
"3200",FALSE,FALSE,"Mel Payton",77824,1,1951,1952
"3201",TRUE,FALSE,"Gary Payton II",1627780,4,2016,2020
"3202",FALSE,FALSE,"George Pearcy",77825,0,1946,1946
"3203",FALSE,FALSE,"Henry Pearcy",77826,0,1946,1946
"3204",FALSE,FALSE,"Oleksiy Pecherov",200762,2,2007,2009
"3205",FALSE,FALSE,"Wiley Peck",77827,0,1979,1979
"3206",FALSE,FALSE,"Anthony Peeler",324,12,1992,2004
"3207",FALSE,FALSE,"Nikola Pekovic",201593,6,2010,2016
"3208",FALSE,FALSE,"Jake Pelkington",77828,0,1948,1948
"3209",TRUE,FALSE,"Norvel Pelle",203658,1,2019,2020
"3210",FALSE,FALSE,"Sam Pellom",77829,3,1979,1982
"3211",FALSE,FALSE,"Mike Penberthy",2130,1,2000,2001
"3212",FALSE,FALSE,"Desmond Penigar",2667,0,2003,2003
"3213",FALSE,FALSE,"Kirk Penney",2632,1,2003,2004
"3214",FALSE,FALSE,"Mike Peplowski",46,2,1993,1995
"3215",FALSE,FALSE,"Will Perdue",781,12,1988,2000
"3216",FALSE,FALSE,"Kendrick Perkins",2570,14,2003,2017
"3217",FALSE,FALSE,"Sam Perkins",64,16,1984,2000
"3218",FALSE,FALSE,"Warren Perkins",77834,1,1949,1950
"3219",FALSE,FALSE,"Kosta Perovic",200785,0,2007,2007
"3220",FALSE,FALSE,"London Perrantes",1628506,0,2017,2017
"3221",FALSE,FALSE,"Curtis Perry",77835,7,1970,1977
"3222",FALSE,FALSE,"Elliot Perry",386,10,1991,2001
"3223",TRUE,TRUE,"Reggie Perry",1629617,0,2020,2020
"3224",FALSE,FALSE,"Tim Perry",897,7,1988,1995
"3225",FALSE,FALSE,"Chuck Person",456,13,1986,1999
"3226",FALSE,FALSE,"Wesley Person",445,10,1994,2004
"3227",FALSE,FALSE,"Alec Peters",1628409,0,2017,2017
"3228",FALSE,FALSE,"Jim Petersen",77839,7,1984,1991
"3229",FALSE,FALSE,"Loy Petersen",77840,1,1968,1969
"3230",FALSE,FALSE,"Bob Peterson",77843,2,1953,1955
"3231",FALSE,FALSE,"Ed Peterson",77841,1,1949,1950
"3232",FALSE,FALSE,"Mel Peterson",77842,0,1963,1963
"3233",FALSE,FALSE,"Morris Peterson",2050,10,2000,2010
"3234",FALSE,FALSE,"Geoff Petrie",77844,5,1970,1975
"3235",FALSE,FALSE,"Johan Petro",101130,7,2005,2012
"3236",FALSE,FALSE,"Drazen Petrovic",77845,3,1989,1992
"3237",FALSE,FALSE,"Richard Petruska",77846,0,1993,1993
"3238",FALSE,FALSE,"Bob Pettit",77847,10,1954,1964
"3239",FALSE,FALSE,"Roger Phegley",77848,5,1978,1983
"3240",FALSE,FALSE,"Jack Phelan",77850,0,1949,1949
"3241",FALSE,FALSE,"Jim Phelan",77849,0,1953,1953
"3242",FALSE,FALSE,"Derrick Phelps",74,0,1994,1994
"3243",FALSE,FALSE,"Mike Phelps",77852,2,1985,1987
"3244",FALSE,FALSE,"Andy Phillip",77853,10,1947,1957
"3245",FALSE,FALSE,"Tarik Phillip",1629341,0,2018,2018
"3246",FALSE,FALSE,"Eddie Phillips",77854,0,1982,1982
"3247",FALSE,FALSE,"Gary Phillips",77855,4,1961,1965
"3248",FALSE,FALSE,"Bobby Phills",184,8,1991,1999
"3249",FALSE,FALSE,"Eric Piatkowski",15,13,1994,2007
"3250",FALSE,FALSE,"Paul Pierce",1718,18,1998,2016
"3251",FALSE,FALSE,"Ricky Pierce",894,15,1982,1997
"3252",FALSE,FALSE,"Stan Pietkiewicz",77858,2,1978,1980
"3253",FALSE,FALSE,"Mickael Pietrus",2554,9,2003,2012
"3254",FALSE,FALSE,"John Pilch",77859,0,1951,1951
"3255",FALSE,FALSE,"Ed Pinckney",291,11,1985,1996
"3256",FALSE,FALSE,"Kevinn Pinkney",200838,0,2006,2006
"3257",FALSE,FALSE,"John Pinone",77861,0,1983,1983
"3258",TRUE,FALSE,"Theo Pinson",1629033,2,2018,2020
"3259",FALSE,FALSE,"Dave Piontek",77862,6,1956,1962
"3260",FALSE,FALSE,"Tom Piotrowski",77863,0,1983,1983
"3261",FALSE,FALSE,"Scottie Pippen",937,16,1987,2003
"3262",FALSE,FALSE,"Charlie Pittman",77864,3,1982,1985
"3263",FALSE,FALSE,"Dexter Pittman",202354,3,2010,2013
"3264",FALSE,FALSE,"Zoran Planinic",2565,2,2003,2005
"3265",FALSE,FALSE,"Tibor Pleiss",202353,0,2015,2015
"3266",FALSE,FALSE,"Marshall Plumlee",1627850,1,2016,2017
"3267",TRUE,FALSE,"Mason Plumlee",203486,7,2013,2020
"3268",FALSE,FALSE,"Miles Plumlee",203101,6,2012,2018
"3269",FALSE,FALSE,"Gary Plummer",77865,8,1984,1992
"3270",FALSE,FALSE,"Pavel Podkolzin",2750,1,2004,2005
"3271",TRUE,FALSE,"Jakob Poeltl",1627751,4,2016,2020
"3272",FALSE,FALSE,"Vincent Poirier",1629738,1,2019,2020
"3273",TRUE,TRUE,"Aleksej Pokusevski",1630197,0,2020,2020
"3274",FALSE,FALSE,"Dwayne Polee",77866,0,1986,1986
"3275",FALSE,FALSE,"Jim Pollard",77867,6,1948,1954
"3276",FALSE,FALSE,"Scot Pollard",1513,10,1997,2007
"3277",FALSE,FALSE,"Ralph Polson",77868,0,1952,1952
"3278",FALSE,FALSE,"Olden Polynice",178,16,1987,2003
"3279",FALSE,FALSE,"Cliff Pondexter",77869,2,1975,1977
"3280",FALSE,FALSE,"Quincy Pondexter",202347,8,2010,2018
"3281",FALSE,FALSE,"Shamorie Ponds",1629044,0,2019,2019
"3282",TRUE,FALSE,"Jordan Poole",1629673,1,2019,2020
"3283",FALSE,FALSE,"David Pope",77870,1,1984,1985
"3284",FALSE,FALSE,"Mark Pope",998,7,1997,2004
"3285",FALSE,FALSE,"Dave Popson",77872,3,1988,1991
"3286",FALSE,FALSE,"Ben Poquette",77873,9,1977,1986
"3287",FALSE,FALSE,"Chris Porter",2084,0,2000,2000
"3288",FALSE,FALSE,"Howard Porter",77875,6,1971,1977
"3289",TRUE,FALSE,"Jontay Porter",1629007,1,2019,2020
"3290",FALSE,FALSE,"Kevin Porter",77876,10,1972,1982
"3291",FALSE,FALSE,"Terry Porter",345,16,1985,2001
"3292",TRUE,FALSE,"Kevin Porter Jr.",1629645,1,2019,2020
"3293",TRUE,FALSE,"Michael Porter Jr.",1629008,2,2018,2020
"3294",TRUE,FALSE,"Otto Porter Jr.",203490,7,2013,2020
"3295",TRUE,FALSE,"Bobby Portis",1626171,5,2015,2020
"3296",FALSE,FALSE,"Bob Portman",77878,3,1969,1972
"3297",TRUE,FALSE,"Kristaps Porzingis",204001,5,2015,2020
"3298",FALSE,FALSE,"James Posey",1899,11,1999,2010
"3299",FALSE,FALSE,"Lavor Postell",2068,2,2000,2002
"3300",FALSE,FALSE,"Vitaly Potapenko",958,10,1996,2006
"3301",FALSE,FALSE,"Leon Powe",200796,4,2006,2010
"3302",TRUE,FALSE,"Dwight Powell",203939,6,2014,2020
"3303",FALSE,FALSE,"Josh Powell",2694,8,2005,2013
"3304",FALSE,FALSE,"Kasib Powell",2867,0,2007,2007
"3305",TRUE,FALSE,"Norman Powell",1626181,5,2015,2020
"3306",FALSE,FALSE,"Roger Powell",101232,0,2006,2006
"3307",FALSE,FALSE,"Alex Poythress",1627816,2,2016,2018
"3308",FALSE,FALSE,"Paul Pressey",77879,10,1982,1992
"3309",FALSE,FALSE,"Phil Pressey",203515,2,2013,2015
"3310",FALSE,FALSE,"Dominic Pressley",77880,0,1988,1988
"3311",FALSE,FALSE,"Harold Pressley",77881,3,1986,1989
"3312",FALSE,FALSE,"AJ Price",201985,5,2009,2014
"3313",FALSE,FALSE,"Brent Price",85,10,1992,2002
"3314",FALSE,FALSE,"Jim Price",77883,6,1972,1978
"3315",FALSE,FALSE,"Mark Price",899,11,1986,1997
"3316",FALSE,FALSE,"Mike Price",77884,2,1970,1972
"3317",FALSE,FALSE,"Ronnie Price",101179,11,2005,2016
"3318",FALSE,FALSE,"Tony Price",77882,0,1980,1980
"3319",FALSE,FALSE,"Bob Priddy",77886,0,1952,1952
"3320",FALSE,FALSE,"Pablo Prigioni",203143,3,2012,2015
"3321",TRUE,FALSE,"Taurean Prince",1627752,4,2016,2020
"3322",FALSE,FALSE,"Tayshaun Prince",2419,13,2002,2015
"3323",FALSE,FALSE,"John Pritchard",77887,0,1949,1949
"3324",FALSE,FALSE,"Kevin Pritchard",340,5,1990,1995
"3325",TRUE,TRUE,"Payton Pritchard",1630202,0,2020,2020
"3326",FALSE,FALSE,"Laron Profit",1919,6,1999,2005
"3327",FALSE,FALSE,"Gabe Pruitt",201172,1,2007,2008
"3328",FALSE,FALSE,"Joel Przybilla",2038,12,2000,2012
"3329",FALSE,FALSE,"Les Pugh",77888,1,1948,1949
"3330",FALSE,FALSE,"Roy Pugh",77889,0,1948,1948
"3331",FALSE,FALSE,"Anthony Pullard",77890,0,1992,1992
"3332",FALSE,FALSE,"Jacob Pullen",1626643,0,2017,2017
"3333",FALSE,FALSE,"Rodney Purvis",1628681,0,2017,2017
"3334",FALSE,FALSE,"Don Putman",77891,3,1946,1949
"3335",FALSE,FALSE,"Zhou Qi",1627753,1,2017,2018
"3336",FALSE,FALSE,"Tim Quarterman",1627817,1,2016,2017
"3337",FALSE,FALSE,"Bob Quick",77892,3,1968,1971
"3338",TRUE,TRUE,"Immanuel Quickley",1630193,0,2020,2020
"3339",FALSE,FALSE,"Chris Quinn",200809,6,2006,2012
"3340",FALSE,FALSE,"Brian Quinnett",77893,2,1989,1991
"3341",FALSE,FALSE,"Ivan Rabb",1628397,1,2017,2018
"3342",FALSE,FALSE,"Luke Rackley",77894,4,1969,1973
"3343",FALSE,FALSE,"Howie Rader",77895,0,1948,1948
"3344",FALSE,FALSE,"Mark Radford",77896,1,1981,1982
"3345",FALSE,FALSE,"Wayne Radford",77897,0,1978,1978
"3346",FALSE,FALSE,"Dino Radja",129,3,1993,1996
"3347",FALSE,FALSE,"Vladimir Radmanovic",2209,11,2001,2012
"3348",FALSE,FALSE,"Aleksandar Radojevic",1893,5,1999,2004
"3349",FALSE,FALSE,"Frank Radovich",77899,0,1961,1961
"3350",FALSE,FALSE,"Moe Radovich",77900,0,1952,1952
"3351",FALSE,FALSE,"Miroslav Raduljica",203545,1,2013,2014
"3352",FALSE,FALSE,"Ray Radziszewski",77901,0,1957,1957
"3353",FALSE,FALSE,"Ray Ragelis",77902,0,1951,1951
"3354",FALSE,FALSE,"Sherwin Raiken",77903,0,1952,1952
"3355",FALSE,FALSE,"Ed Rains",77904,1,1981,1982
"3356",FALSE,FALSE,"Igor Rakocevic",2080,0,2002,2002
"3357",FALSE,FALSE,"Kurt Rambis",77905,13,1981,1994
"3358",FALSE,FALSE,"Peter John Ramos",2762,0,2004,2004
"3359",FALSE,FALSE,"Cal Ramsey",77906,1,1959,1960
"3360",FALSE,FALSE,"Frank Ramsey",77907,9,1954,1963
"3361",TRUE,TRUE,"Jahmi'us Ramsey",1630186,0,2020,2020
"3362",FALSE,FALSE,"Ray Ramsey",77908,0,1948,1948
"3363",FALSE,FALSE,"Mark Randall",1821,3,1991,1994
"3364",TRUE,FALSE,"Chasson Randle",1626184,4,2016,2020
"3365",TRUE,FALSE,"Julius Randle",203944,6,2014,2020
"3366",FALSE,FALSE,"Anthony Randolph",201576,5,2008,2013
"3367",FALSE,FALSE,"Shavlik Randolph",101183,9,2005,2014
"3368",FALSE,FALSE,"Zach Randolph",2216,16,2001,2017
"3369",FALSE,FALSE,"Wally Rank",77910,0,1980,1980
"3370",FALSE,FALSE,"Kelvin Ransey",77911,5,1980,1985
"3371",FALSE,FALSE,"Sam Ranzino",77912,0,1951,1951
"3372",FALSE,FALSE,"Blair Rasmussen",78656,7,1985,1992
"3373",FALSE,FALSE,"Xavier Rathan-Mayes",1628504,0,2017,2017
"3374",FALSE,FALSE,"George Ratkovicz",77913,5,1949,1954
"3375",FALSE,FALSE,"Ed Ratleff",77914,4,1973,1977
"3376",FALSE,FALSE,"Mike Ratliff",77915,1,1972,1973
"3377",FALSE,FALSE,"Theo Ratliff",689,15,1995,2010
"3378",FALSE,FALSE,"Andy Rautins",202360,0,2010,2010
"3379",FALSE,FALSE,"Leo Rautins",77916,1,1983,1984
"3380",FALSE,FALSE,"Allan Ray",200810,0,2006,2006
"3381",FALSE,FALSE,"Clifford Ray",77917,9,1971,1980
"3382",FALSE,FALSE,"Don Ray",77918,0,1949,1949
"3383",FALSE,FALSE,"Jamesearl Ray",77920,2,1980,1982
"3384",FALSE,FALSE,"Jim Ray",77919,3,1956,1959
"3385",FALSE,FALSE,"Craig Raymond",77921,0,1968,1968
"3386",FALSE,FALSE,"Connie Rea",77922,0,1953,1953
"3387",FALSE,FALSE,"Joe Reaves",77923,0,1973,1973
"3388",FALSE,FALSE,"Josh Reaves",1629729,0,2019,2019
"3389",FALSE,FALSE,"Zeljko Rebraca",1442,4,2001,2005
"3390",FALSE,FALSE,"Eldridge Recasner",695,7,1994,2001
"3391",FALSE,FALSE,"Michael Redd",2072,11,2000,2011
"3392",TRUE,FALSE,"Cam Reddish",1629629,1,2019,2020
"3393",FALSE,FALSE,"Frank Reddout",77925,0,1953,1953
"3394",TRUE,FALSE,"JJ Redick",200755,14,2006,2020
"3395",FALSE,FALSE,"Marlon Redmond",77926,1,1978,1979
"3396",FALSE,FALSE,"Davon Reed",1628432,1,2017,2018
"3397",FALSE,FALSE,"Hub Reed",77927,6,1958,1964
"3398",FALSE,FALSE,"Justin Reed",2770,2,2004,2006
"3399",TRUE,TRUE,"Paul Reed",1630194,0,2020,2020
"3400",FALSE,FALSE,"Ron Reed",77928,1,1965,1966
"3401",FALSE,FALSE,"Willie Reed",203186,5,2012,2017
"3402",FALSE,FALSE,"Willis Reed",77929,9,1964,1973
"3403",FALSE,FALSE,"Bryant Reeves",735,5,1995,2000
"3404",FALSE,FALSE,"Khalid Reeves",234,5,1994,1999
"3405",FALSE,FALSE,"Richie Regan",77932,2,1955,1957
"3406",FALSE,FALSE,"Don Rehfeldt",77933,1,1950,1951
"3407",FALSE,FALSE,"Billy Reid",77937,0,1980,1980
"3408",FALSE,FALSE,"Don Reid",690,7,1995,2002
"3409",FALSE,FALSE,"J.R. Reid",462,11,1989,2000
"3410",FALSE,FALSE,"Jim Reid",77935,0,1967,1967
"3411",TRUE,FALSE,"Naz Reid",1629675,1,2019,2020
"3412",FALSE,FALSE,"Robert Reid",77936,13,1977,1990
"3413",FALSE,FALSE,"Ryan Reid",202385,0,2011,2011
"3414",FALSE,FALSE,"Jared Reiner",2876,2,2004,2006
"3415",FALSE,FALSE,"Joseph Reiser",77938,2,1947,1949
"3416",FALSE,FALSE,"Richard Rellford",77939,0,1987,1987
"3417",FALSE,FALSE,"Terrence Rencher",720,0,1995,1995
"3418",FALSE,FALSE,"John Rennicke",77941,0,1951,1951
"3419",FALSE,FALSE,"Rob Rensberger",77942,0,1946,1946
"3420",FALSE,FALSE,"Efthimios Rentzias",981,0,2002,2002
"3421",FALSE,FALSE,"Shawn Respert",704,3,1995,1998
"3422",FALSE,FALSE,"Kevin Restani",77944,7,1974,1981
"3423",FALSE,FALSE,"Cameron Reynolds",1629244,2,2018,2020
"3424",FALSE,FALSE,"George Reynolds",77945,0,1969,1969
"3425",FALSE,FALSE,"Jerry Reynolds",77946,10,1985,1995
"3426",FALSE,FALSE,"Gene Rhodes",77947,0,1952,1952
"3427",FALSE,FALSE,"Rodrick Rhodes",1518,2,1997,1999
"3428",FALSE,FALSE,"Glen Rice",779,14,1989,2003
"3429",FALSE,FALSE,"Glen Rice Jr.",203318,1,2013,2014
"3430",FALSE,FALSE,"Chris Richard",201181,2,2007,2009
"3431",TRUE,TRUE,"Nick Richards",1630208,0,2020,2020
"3432",FALSE,FALSE,"Clint Richardson",77950,7,1979,1986
"3433",FALSE,FALSE,"Jason Richardson",2202,13,2001,2014
"3434",FALSE,FALSE,"Jeremy Richardson",200978,2,2006,2008
"3435",TRUE,FALSE,"Josh Richardson",1626196,5,2015,2020
"3436",FALSE,FALSE,"Malachi Richardson",1627781,2,2016,2018
"3437",FALSE,FALSE,"Micheal Ray Richardson",77952,7,1978,1985
"3438",FALSE,FALSE,"Norman Richardson",2369,0,2001,2001
"3439",FALSE,FALSE,"Pooh Richardson",71,9,1989,1998
"3440",FALSE,FALSE,"Quentin Richardson",2047,12,2000,2012
"3441",FALSE,FALSE,"Mitch Richmond",782,13,1988,2001
"3442",FALSE,FALSE,"John Richter",77954,0,1959,1959
"3443",FALSE,FALSE,"Dick Ricketts",77955,2,1955,1957
"3444",FALSE,FALSE,"Isaiah Rider",375,8,1993,2001
"3445",FALSE,FALSE,"Jackie Ridgle",77957,0,1971,1971
"3446",FALSE,FALSE,"Luke Ridnour",2557,11,2003,2014
"3447",FALSE,FALSE,"Mel Riebe",77958,2,1946,1948
"3448",FALSE,FALSE,"Jim Riffey",77959,0,1950,1950
"3449",FALSE,FALSE,"Antoine Rigaudeau",2541,0,2002,2002
"3450",FALSE,FALSE,"Tom Riker",77960,2,1972,1974
"3451",FALSE,FALSE,"Bob Riley",77963,0,1970,1970
"3452",FALSE,FALSE,"Eric Riley",35,5,1993,1998
"3453",FALSE,FALSE,"Pat Riley",77962,8,1967,1975
"3454",FALSE,FALSE,"Ron Riley",77964,3,1972,1975
"3455",TRUE,TRUE,"Grant Riller",1630203,0,2020,2020
"3456",FALSE,FALSE,"Rich Rinaldi",77965,2,1971,1973
"3457",FALSE,FALSE,"Mike Riordan",77966,8,1968,1976
"3458",FALSE,FALSE,"Arnie Risen",77967,9,1948,1957
"3459",FALSE,FALSE,"Goebel Ritter",77968,2,1948,1950
"3460",FALSE,FALSE,"Ramon Rivas",77969,0,1988,1988
"3461",TRUE,FALSE,"Austin Rivers",203085,8,2012,2020
"3462",FALSE,FALSE,"David Rivers",77970,3,1988,1991
"3463",FALSE,FALSE,"Doc Rivers",470,12,1983,1995
"3464",FALSE,FALSE,"Lee Robbins",77972,1,1947,1948
"3465",FALSE,FALSE,"Andre Roberson",203460,7,2013,2020
"3466",FALSE,FALSE,"Anthony Roberson",101194,3,2005,2008
"3467",FALSE,FALSE,"Rick Roberson",77973,6,1969,1975
"3468",FALSE,FALSE,"Terrance Roberson",2121,0,2000,2000
"3469",FALSE,FALSE,"Anthony Roberts",77975,6,1977,1983
"3470",FALSE,FALSE,"Bill Roberts",77979,1,1948,1949
"3471",FALSE,FALSE,"Brian Roberts",203148,4,2012,2016
"3472",FALSE,FALSE,"Fred Roberts",122,13,1983,1996
"3473",FALSE,FALSE,"Joe Roberts",77977,2,1960,1962
"3474",FALSE,FALSE,"Lawrence Roberts",101160,1,2005,2006
"3475",FALSE,FALSE,"Marv Roberts",77978,0,1976,1976
"3476",FALSE,FALSE,"Stanley Roberts",914,8,1991,1999
"3477",FALSE,FALSE,"Alvin Robertson",926,11,1984,1995
"3478",FALSE,FALSE,"Oscar Robertson",600015,13,1960,1973
"3479",FALSE,FALSE,"Ryan Robertson",1926,0,1999,1999
"3480",FALSE,FALSE,"Tony Robertson",77983,1,1977,1978
"3481",FALSE,FALSE,"Rick Robey",77984,7,1978,1985
"3482",FALSE,FALSE,"Bernard Robinson",2774,2,2004,2006
"3483",FALSE,FALSE,"Chris Robinson",997,1,1996,1997
"3484",FALSE,FALSE,"Cliff T. Robinson",77986,12,1979,1991
"3485",FALSE,FALSE,"Clifford Robinson",361,17,1989,2006
"3486",FALSE,FALSE,"David Robinson",764,13,1989,2002
"3487",FALSE,FALSE,"Devin Robinson",1628421,1,2017,2018
"3488",TRUE,FALSE,"Duncan Robinson",1629130,2,2018,2020
"3489",FALSE,FALSE,"Eddie Robinson",1944,4,1999,2003
"3490",FALSE,FALSE,"Flynn Robinson",77988,6,1966,1972
"3491",FALSE,FALSE,"Glenn Robinson",299,10,1994,2004
"3492",FALSE,FALSE,"Jackie Robinson",77989,3,1978,1981
"3493",FALSE,FALSE,"Jamal Robinson",1554,0,2000,2000
"3494",FALSE,FALSE,"James Robinson",381,7,1993,2000
"3495",FALSE,FALSE,"Jerome Robinson",1629010,2,2018,2020
"3496",FALSE,FALSE,"Justin Robinson",1629620,1,2019,2020
"3497",FALSE,FALSE,"Larry Robinson",1683,11,1990,2001
"3498",TRUE,FALSE,"Mitchell Robinson",1629011,2,2018,2020
"3499",FALSE,FALSE,"Nate Robinson",101126,10,2005,2015
"3500",FALSE,FALSE,"Oliver Robinson",77994,0,1982,1982
"3501",FALSE,FALSE,"Rumeal Robinson",716,6,1990,1996
"3502",FALSE,FALSE,"Thomas Robinson",203080,4,2012,2016
"3503",FALSE,FALSE,"Truck Robinson",77993,10,1974,1984
"3504",FALSE,FALSE,"Wayne Robinson",77996,0,1980,1980
"3505",FALSE,FALSE,"Glenn Robinson III",203922,6,2014,2020
"3506",FALSE,FALSE,"Bill Robinzine",77997,6,1975,1981
"3507",FALSE,FALSE,"Dave Robisch",77998,7,1976,1983
"3508",TRUE,FALSE,"Isaiah Roby",1629676,1,2019,2020
"3509",FALSE,FALSE,"Red Rocha",77999,9,1947,1956
"3510",FALSE,FALSE,"John Roche",78000,6,1975,1981
"3511",FALSE,FALSE,"Gene Rock",78001,0,1947,1947
"3512",FALSE,FALSE,"Jack Rocker",78002,0,1947,1947
"3513",FALSE,FALSE,"Guy Rodgers",78003,11,1958,1969
"3514",FALSE,FALSE,"Dennis Rodman",23,13,1986,1999
"3515",FALSE,FALSE,"Sergio Rodriguez",200771,10,2006,2016
"3516",FALSE,FALSE,"Lou Roe",691,1,1995,1996
"3517",FALSE,FALSE,"Carlos Rogers",435,7,1994,2001
"3518",FALSE,FALSE,"Johnny Rogers",78007,1,1986,1987
"3519",FALSE,FALSE,"Marshall Rogers",78008,0,1976,1976
"3520",FALSE,FALSE,"Rodney Rogers",915,11,1993,2004
"3521",FALSE,FALSE,"Roy Rogers",964,3,1996,1999
"3522",FALSE,FALSE,"Al Roges",78010,1,1953,1954
"3523",FALSE,FALSE,"Ken Rohloff",78011,0,1963,1963
"3524",FALSE,FALSE,"Magnum Rolle",202375,0,2010,2010
"3525",FALSE,FALSE,"Kenny Rollins",78012,4,1948,1952
"3526",FALSE,FALSE,"Phil Rollins",78013,2,1958,1960
"3527",FALSE,FALSE,"Tree Rollins",78014,17,1977,1994
"3528",FALSE,FALSE,"Lorenzo Romar",78015,4,1980,1984
"3529",TRUE,FALSE,"Rajon Rondo",200765,14,2006,2020
"3530",FALSE,FALSE,"Sean Rooks",399,11,1992,2003
"3531",TRUE,FALSE,"Derrick Rose",201565,12,2008,2020
"3532",FALSE,FALSE,"Jalen Rose",147,12,1994,2006
"3533",FALSE,FALSE,"Malik Rose",990,12,1996,2008
"3534",FALSE,FALSE,"Robert Rose",78016,0,1988,1988
"3535",FALSE,FALSE,"Alexander Rosenberg",78017,0,1946,1946
"3536",FALSE,FALSE,"Lennie Rosenbluth",78018,1,1957,1958
"3537",FALSE,FALSE,"Hank Rosenstein",78019,0,1946,1946
"3538",FALSE,FALSE,"Dick Rosenthal",78020,2,1954,1956
"3539",FALSE,FALSE,"Quinton Ross",2624,6,2004,2010
"3540",TRUE,FALSE,"Terrence Ross",203082,8,2012,2020
"3541",FALSE,FALSE,"Doug Roth",78021,0,1989,1989
"3542",FALSE,FALSE,"Scott Roth",78022,2,1987,1989
"3543",FALSE,FALSE,"Irv Rothenberg",78023,2,1946,1948
"3544",FALSE,FALSE,"Mickey Rottner",78024,1,1946,1947
"3545",FALSE,FALSE,"Dan Roundfield",78025,10,1976,1986
"3546",FALSE,FALSE,"Giff Roux",78026,2,1946,1948
"3547",FALSE,FALSE,"Ron Rowan",78027,0,1986,1986
"3548",FALSE,FALSE,"Curtis Rowe",78028,7,1971,1978
"3549",FALSE,FALSE,"Jim Rowinski",78029,1,1988,1989
"3550",FALSE,FALSE,"Derrick Rowland",78030,0,1985,1985
"3551",FALSE,FALSE,"Brian Rowsom",78031,2,1987,1989
"3552",FALSE,FALSE,"Brandon Roy",200750,6,2006,2012
"3553",FALSE,FALSE,"Donald Royal",140,8,1989,1997
"3554",FALSE,FALSE,"Bob Royer",78033,0,1949,1949
"3555",FALSE,FALSE,"Clifford Rozier",32,3,1994,1997
"3556",TRUE,FALSE,"Terry Rozier",1626179,5,2015,2020
"3557",TRUE,FALSE,"Ricky Rubio",201937,9,2011,2020
"3558",FALSE,FALSE,"Guy Rucker",2462,0,2002,2002
"3559",FALSE,FALSE,"Delaney Rudd",78035,3,1989,1992
"3560",FALSE,FALSE,"John Rudd",78036,0,1978,1978
"3561",FALSE,FALSE,"Damjan Rudez",204014,2,2014,2016
"3562",FALSE,FALSE,"John Rudometkin",78037,2,1962,1964
"3563",FALSE,FALSE,"Michael Ruffin",1913,9,1999,2008
"3564",FALSE,FALSE,"Trevor Ruffin",460,1,1994,1995
"3565",FALSE,FALSE,"Paul Ruffner",78039,4,1970,1974
"3566",FALSE,FALSE,"Joe Ruklick",78040,2,1959,1961
"3567",FALSE,FALSE,"Jeff Ruland",78041,11,1981,1992
"3568",FALSE,FALSE,"Bob Rule",78042,7,1967,1974
"3569",FALSE,FALSE,"Jerry Rullo",78043,3,1946,1949
"3570",FALSE,FALSE,"Stefano Rusconi",474,0,1995,1995
"3571",FALSE,FALSE,"Brandon Rush",201575,8,2008,2016
"3572",FALSE,FALSE,"Kareem Rush",2416,7,2002,2009
"3573",FALSE,FALSE,"Bill Russell",78049,12,1956,1968
"3574",FALSE,FALSE,"Bryon Russell",935,12,1993,2005
"3575",FALSE,FALSE,"Campy Russell",78047,10,1974,1984
"3576",FALSE,FALSE,"Cazzie Russell",78045,11,1966,1977
"3577",TRUE,FALSE,"D'Angelo Russell",1626156,5,2015,2020
"3578",FALSE,FALSE,"Frank Russell",78046,0,1972,1972
"3579",FALSE,FALSE,"Walker Russell",78048,5,1982,1987
"3580",FALSE,FALSE,"Walker Russell",201041,0,2011,2011
"3581",FALSE,FALSE,"Arvydas Sabonis",717,7,1995,2002
"3582",TRUE,FALSE,"Domantas Sabonis",1627734,4,2016,2020
"3583",FALSE,FALSE,"Robert Sacre",203135,3,2012,2015
"3584",FALSE,FALSE,"Ed Sadowski",78050,3,1946,1949
"3585",FALSE,FALSE,"Kenny Sailors",78051,4,1946,1950
"3586",FALSE,FALSE,"John Salley",927,13,1986,1999
"3587",FALSE,FALSE,"John Salmons",2422,12,2002,2014
"3588",FALSE,FALSE,"Kevin Salvadori",1089,1,1996,1997
"3589",FALSE,FALSE,"Soumaila Samake",2066,2,2000,2002
"3590",TRUE,FALSE,"Luka Samanic",1629677,1,2019,2020
"3591",FALSE,FALSE,"Cheikh Samb",200798,1,2007,2008
"3592",FALSE,FALSE,"Brandon Sampson",1629102,0,2018,2018
"3593",TRUE,FALSE,"JaKarr Sampson",203960,6,2014,2020
"3594",FALSE,FALSE,"Jamal Sampson",2441,4,2002,2006
"3595",FALSE,FALSE,"Ralph Sampson",78055,8,1983,1991
"3596",FALSE,FALSE,"Samardo Samuels",202396,2,2010,2012
"3597",FALSE,FALSE,"Pepe Sanchez",2143,2,2000,2002
"3598",FALSE,FALSE,"Frankie Sanders",78057,2,1978,1980
"3599",FALSE,FALSE,"Jeff Sanders",1874,3,1989,1992
"3600",FALSE,FALSE,"Larry Sanders",202336,6,2010,2016
"3601",FALSE,FALSE,"Melvin Sanders",2684,0,2005,2005
"3602",FALSE,FALSE,"Mike Sanders",78059,10,1982,1992
"3603",FALSE,FALSE,"Thomas Sanders",78060,12,1960,1972
"3604",FALSE,FALSE,"Daniel Santiago",2091,4,2000,2004
"3605",FALSE,FALSE,"Bob Santini",78061,0,1955,1955
"3606",FALSE,FALSE,"Wayne Sappleton",78062,0,1984,1984
"3607",TRUE,FALSE,"Dario Saric",203967,4,2016,2020
"3608",FALSE,FALSE,"Jason Sasser",987,6,1996,2002
"3609",FALSE,FALSE,"Jeryl Sasser",2219,1,2001,2002
"3610",TRUE,FALSE,"Tomas Satoransky",203107,4,2016,2020
"3611",FALSE,FALSE,"Kenny Satterfield",2261,1,2001,2002
"3612",FALSE,FALSE,"Frank Saul",78063,5,1949,1954
"3613",FALSE,FALSE,"Woody Sauldsberry",78064,8,1957,1965
"3614",FALSE,FALSE,"Fred Saunders",78065,3,1974,1977
"3615",FALSE,FALSE,"Don Savage",78066,5,1951,1956
"3616",FALSE,FALSE,"Predrag Savovic",2453,0,2002,2002
"3617",FALSE,FALSE,"Alan Sawyer",78067,0,1950,1950
"3618",FALSE,FALSE,"Brian Scalabrine",2243,10,2001,2011
"3619",FALSE,FALSE,"Alex Scales",2637,0,2005,2005
"3620",FALSE,FALSE,"Dewayne Scales",78068,3,1980,1983
"3621",FALSE,FALSE,"Frank Schade",78069,0,1972,1972
"3622",FALSE,FALSE,"Ben Schadler",78070,0,1947,1947
"3623",FALSE,FALSE,"Herm Schaefer",78071,1,1948,1949
"3624",FALSE,FALSE,"Bob Schafer",78072,0,1955,1955
"3625",FALSE,FALSE,"Ben Scharnus",78073,2,1946,1948
"3626",FALSE,FALSE,"Marv Schatzman",78074,0,1949,1949
"3627",FALSE,FALSE,"Fred Schaus",78075,4,1949,1953
"3628",FALSE,FALSE,"Dan Schayes",7,17,1981,1998
"3629",FALSE,FALSE,"Dolph Schayes",78076,14,1949,1963
"3630",FALSE,FALSE,"Ossie Schectman",78078,0,1946,1946
"3631",FALSE,FALSE,"Steve Scheffler",88,6,1990,1996
"3632",FALSE,FALSE,"Tom Scheffler",78080,0,1984,1984
"3633",FALSE,FALSE,"Dave Schellhase",78081,1,1966,1967
"3634",FALSE,FALSE,"Luke Schenscher",101195,1,2005,2006
"3635",FALSE,FALSE,"Herb Scherer",78082,1,1950,1951
"3636",FALSE,FALSE,"Dwayne Schintzius",368,8,1990,1998
"3637",FALSE,FALSE,"Dale Schlueter",78084,9,1968,1977
"3638",FALSE,FALSE,"Otto Schnellbacher",78085,0,1948,1948
"3639",FALSE,FALSE,"Dick Schnittker",78086,7,1950,1957
"3640",FALSE,FALSE,"Russ Schoene",78087,6,1982,1988
"3641",FALSE,FALSE,"Admiral Schofield",1629678,0,2019,2019
"3642",FALSE,FALSE,"Dave Scholz",78088,0,1969,1969
"3643",FALSE,FALSE,"Milt Schoon",78089,3,1946,1949
"3644",FALSE,FALSE,"Detlef Schrempf",96,15,1985,2000
"3645",TRUE,FALSE,"Dennis Schroder",203471,7,2013,2020
"3646",FALSE,FALSE,"Howie Schultz",78091,3,1949,1952
"3647",FALSE,FALSE,"Dick Schulz",78092,3,1946,1949
"3648",FALSE,FALSE,"John Schweitz",78093,2,1984,1986
"3649",FALSE,FALSE,"Luis Scola",2449,9,2007,2016
"3650",FALSE,FALSE,"Freddie Scolari",78094,8,1946,1954
"3651",FALSE,FALSE,"Alvin Scott",78095,7,1977,1984
"3652",FALSE,FALSE,"Brent Scott",1064,0,1996,1996
"3653",FALSE,FALSE,"Byron Scott",2,13,1983,1996
"3654",FALSE,FALSE,"Charlie Scott",78097,8,1971,1979
"3655",FALSE,FALSE,"Dennis Scott",192,9,1990,1999
"3656",FALSE,FALSE,"James Scott",1109,0,1996,1996
"3657",TRUE,FALSE,"Mike Scott",203118,8,2012,2020
"3658",FALSE,FALSE,"Ray Scott",78100,8,1961,1969
"3659",FALSE,FALSE,"Shawnelle Scott",1035,5,1996,2001
"3660",TRUE,TRUE,"Jay Scrubb",1630206,0,2020,2020
"3661",FALSE,FALSE,"Carey Scurry",78102,2,1985,1987
"3662",FALSE,FALSE,"Bruce Seals",78103,2,1975,1977
"3663",FALSE,FALSE,"Shea Seals",1578,0,1997,1997
"3664",FALSE,FALSE,"Malik Sealy",907,7,1992,1999
"3665",FALSE,FALSE,"Ed Searcy",78105,0,1975,1975
"3666",FALSE,FALSE,"Ken Sears",78106,8,1955,1963
"3667",FALSE,FALSE,"Wayne See",78107,0,1949,1949
"3668",FALSE,FALSE,"Thabo Sefolosha",200757,13,2006,2019
"3669",FALSE,FALSE,"Rony Seikaly",938,10,1988,1998
"3670",FALSE,FALSE,"Glen Selbo",78109,0,1949,1949
"3671",FALSE,FALSE,"Josh Selby",202729,1,2011,2012
"3672",FALSE,FALSE,"Wayne Selden",1627782,2,2016,2018
"3673",FALSE,FALSE,"Brad Sellers",78110,6,1986,1992
"3674",FALSE,FALSE,"Phil Sellers",78111,0,1976,1976
"3675",FALSE,FALSE,"Rollie Seltz",78112,0,1949,1949
"3676",FALSE,FALSE,"Frank Selvy",78113,9,1954,1963
"3677",FALSE,FALSE,"Jim Seminoff",78114,3,1946,1949
"3678",FALSE,FALSE,"Mouhamed Sene",200754,2,2006,2008
"3679",FALSE,FALSE,"George Senesky",78115,7,1946,1953
"3680",FALSE,FALSE,"Kevin Seraphin",202338,6,2010,2016
"3681",FALSE,FALSE,"Ansu Sesay",1738,3,2001,2004
"3682",FALSE,FALSE,"Ramon Sessions",201196,10,2007,2017
"3683",FALSE,FALSE,"Tom Sewell",78116,0,1984,1984
"3684",TRUE,FALSE,"Collin Sexton",1629012,2,2018,2020
"3685",FALSE,FALSE,"Paul Seymour",78117,12,1947,1959
"3686",FALSE,FALSE,"Nick Shaback",78118,0,1946,1946
"3687",FALSE,FALSE,"Charles Shackleford",1593,10,1988,1998
"3688",FALSE,FALSE,"Carl Shaeffer",78120,1,1949,1950
"3689",FALSE,FALSE,"Lee Shaffer",78121,2,1961,1963
"3690",FALSE,FALSE,"Mustafa Shakur",201203,4,2009,2013
"3691",TRUE,FALSE,"Landry Shamet",1629013,2,2018,2020
"3692",FALSE,FALSE,"God Shammgod",1539,0,1997,1997
"3693",FALSE,FALSE,"Earl Shannon",78123,2,1946,1948
"3694",FALSE,FALSE,"Howie Shannon",78124,1,1948,1949
"3695",FALSE,FALSE,"Charlie Share",78125,8,1951,1959
"3696",FALSE,FALSE,"Bill Sharman",78126,10,1950,1960
"3697",FALSE,FALSE,"Walter Sharpe",201594,0,2008,2008
"3698",FALSE,FALSE,"John Shasky",1117,2,1988,1990
"3699",FALSE,FALSE,"Ron Shavlik",78128,1,1956,1957
"3700",FALSE,FALSE,"Brian Shaw",216,14,1988,2002
"3701",FALSE,FALSE,"Casey Shaw",1745,4,1998,2002
"3702",FALSE,FALSE,"Marial Shayok",1629621,0,2019,2019
"3703",FALSE,FALSE,"Bob Shea",78130,0,1946,1946
"3704",FALSE,FALSE,"Fred Sheffield",78131,0,1946,1946
"3705",FALSE,FALSE,"Craig Shelton",78132,1,1980,1981
"3706",FALSE,FALSE,"Lonnie Shelton",78133,9,1976,1985
"3707",FALSE,FALSE,"Tornike Shengelia",203129,1,2012,2013
"3708",FALSE,FALSE,"Jeff Sheppard",1852,0,1998,1998
"3709",FALSE,FALSE,"Steve Sheppard",78135,1,1977,1978
"3710",FALSE,FALSE,"Edmund Sherod",78136,0,1982,1982
"3711",FALSE,FALSE,"Charlie Shipp",78653,0,1949,1949
"3712",FALSE,FALSE,"Paul Shirley",2321,2,2002,2004
"3713",FALSE,FALSE,"Gene Short",78138,0,1975,1975
"3714",FALSE,FALSE,"Purvis Short",78139,11,1978,1989
"3715",FALSE,FALSE,"Dexter Shouse",78140,0,1989,1989
"3716",FALSE,FALSE,"Dick Shrider",78141,0,1948,1948
"3717",FALSE,FALSE,"Gene Shue",78142,9,1954,1963
"3718",FALSE,FALSE,"John Shumate",78143,5,1975,1980
"3719",FALSE,FALSE,"Iman Shumpert",202697,9,2011,2020
"3720",FALSE,FALSE,"Alexey Shved",203144,2,2012,2014
"3721",TRUE,FALSE,"Pascal Siakam",1627783,4,2016,2020
"3722",FALSE,FALSE,"Jordan Sibert",1626296,0,2018,2018
"3723",FALSE,FALSE,"Sam Sibert",78144,0,1972,1972
"3724",FALSE,FALSE,"Mark Sibley",78145,0,1973,1973
"3725",FALSE,FALSE,"Jerry Sichting",78146,9,1980,1989
"3726",FALSE,FALSE,"Larry Siegfried",78147,8,1963,1971
"3727",FALSE,FALSE,"Ralph Siewert",78148,0,1946,1946
"3728",FALSE,FALSE,"Jack Sikma",78149,13,1977,1990
"3729",FALSE,FALSE,"James Silas",78150,5,1976,1981
"3730",FALSE,FALSE,"Paul Silas",78151,15,1964,1979
"3731",FALSE,FALSE,"Xavier Silas",202918,6,2011,2017
"3732",FALSE,FALSE,"Garret Siler",202081,0,2010,2010
"3733",FALSE,FALSE,"Mike Silliman",78152,0,1970,1970
"3734",FALSE,FALSE,"Chris Silva",1629735,1,2019,2020
"3735",FALSE,FALSE,"Wayne Simien",101134,1,2005,2006
"3736",TRUE,FALSE,"Ben Simmons",1627732,4,2016,2020
"3737",FALSE,FALSE,"Bobby Simmons",2250,10,2001,2011
"3738",FALSE,FALSE,"Cedric Simmons",200759,2,2006,2008
"3739",FALSE,FALSE,"Connie Simmons",78153,9,1946,1955
"3740",FALSE,FALSE,"Johnny Simmons",78154,0,1946,1946
"3741",FALSE,FALSE,"Jonathon Simmons",203613,3,2015,2018
"3742",FALSE,FALSE,"Kobi Simmons",1628424,2,2017,2019
"3743",FALSE,FALSE,"Lionel Simmons",1489,6,1990,1996
"3744",FALSE,FALSE,"Miles Simon",1750,4,1998,2002
"3745",TRUE,FALSE,"Anfernee Simons",1629014,2,2018,2020
"3746",FALSE,FALSE,"Dickey Simpkins",54,7,1994,2001
"3747",FALSE,FALSE,"Diamon Simpson",202067,0,2011,2011
"3748",FALSE,FALSE,"Ralph Simpson",78157,3,1976,1979
"3749",FALSE,FALSE,"Alvin Sims",1591,0,1998,1998
"3750",FALSE,FALSE,"Bob Sims",78160,0,1961,1961
"3751",FALSE,FALSE,"Courtney Sims",201235,1,2007,2008
"3752",FALSE,FALSE,"Doug Sims",78159,0,1968,1968
"3753",FALSE,FALSE,"Henry Sims",203156,3,2012,2015
"3754",FALSE,FALSE,"Scott Sims",78161,0,1977,1977
"3755",FALSE,FALSE,"Kyle Singler",202713,5,2012,2017
"3756",FALSE,FALSE,"Sean Singletary",201606,0,2008,2008
"3757",FALSE,FALSE,"Chris Singleton",202698,2,2011,2013
"3758",FALSE,FALSE,"James Singleton",101189,6,2005,2011
"3759",FALSE,FALSE,"Mckinley Singleton",78162,0,1986,1986
"3760",FALSE,FALSE,"Zeke Sinicola",78163,2,1951,1953
"3761",TRUE,TRUE,"Deividas Sirvydis",1629686,0,2020,2020
"3762",FALSE,FALSE,"Charlie Sitton",78164,0,1984,1984
"3763",FALSE,FALSE,"Peyton Siva",203491,0,2013,2013
"3764",FALSE,FALSE,"Scott Skiles",101,9,1986,1995
"3765",FALSE,FALSE,"Al Skinner",78167,3,1976,1979
"3766",FALSE,FALSE,"Brian Skinner",1730,13,1998,2011
"3767",FALSE,FALSE,"Talvin Skinner",78168,1,1974,1975
"3768",FALSE,FALSE,"Whitey Skoog",78169,5,1951,1956
"3769",FALSE,FALSE,"Jeff Slade",78170,0,1962,1962
"3770",FALSE,FALSE,"Reggie Slater",1073,8,1994,2002
"3771",FALSE,FALSE,"Jim Slaughter",78171,0,1951,1951
"3772",FALSE,FALSE,"Jose Slaughter",78172,0,1982,1982
"3773",FALSE,FALSE,"Tamar Slay",2447,2,2002,2004
"3774",FALSE,FALSE,"Donald Sloan",202388,4,2011,2015
"3775",FALSE,FALSE,"Jerry Sloan",78173,10,1965,1975
"3776",FALSE,FALSE,"Uros Slokar",101166,0,2006,2006
"3777",FALSE,FALSE,"Tom Sluby",78174,0,1984,1984
"3778",TRUE,FALSE,"Alen Smailagic",1629346,1,2019,2020
"3779",FALSE,FALSE,"Keith Smart",78175,0,1988,1988
"3780",TRUE,FALSE,"Marcus Smart",203935,6,2014,2020
"3781",FALSE,FALSE,"Belus Smawley",78176,5,1946,1951
"3782",FALSE,FALSE,"Jack Smiley",78177,1,1948,1949
"3783",FALSE,FALSE,"Adrian Smith",78178,9,1961,1970
"3784",FALSE,FALSE,"Bill Smith",78207,1,1971,1972
"3785",FALSE,FALSE,"Bill Smith",78209,0,1961,1961
"3786",FALSE,FALSE,"Bingo Smith",78202,10,1969,1979
"3787",FALSE,FALSE,"Bobby Smith",78203,2,1959,1961
"3788",FALSE,FALSE,"Charles Smith",293,8,1988,1996
"3789",FALSE,FALSE,"Charles Smith",1520,8,1997,2005
"3790",FALSE,FALSE,"Charles Smith",78179,6,1989,1995
"3791",FALSE,FALSE,"Chris Smith",1814,2,1992,1994
"3792",FALSE,FALSE,"Chris Smith",203147,0,2013,2013
"3793",FALSE,FALSE,"Clinton Smith",78181,4,1986,1990
"3794",FALSE,FALSE,"Craig Smith",200783,5,2006,2011
"3795",FALSE,FALSE,"Deb Smith",78182,0,1946,1946
"3796",FALSE,FALSE,"Derek Smith",78183,8,1982,1990
"3797",FALSE,FALSE,"Don Smith",78184,0,1974,1974
"3798",FALSE,FALSE,"Donald Smith",78185,0,1948,1948
"3799",FALSE,FALSE,"Donta Smith",2764,1,2004,2005
"3800",FALSE,FALSE,"Doug Smith",475,4,1991,1995
"3801",FALSE,FALSE,"Ed Smith",78187,0,1953,1953
"3802",FALSE,FALSE,"Elmore Smith",78188,7,1971,1978
"3803",FALSE,FALSE,"Garfield Smith",78189,1,1970,1971
"3804",FALSE,FALSE,"Greg Smith",78190,7,1968,1975
"3805",FALSE,FALSE,"Greg Smith",202962,4,2011,2015
"3806",TRUE,FALSE,"Ish Smith",202397,10,2010,2020
"3807",FALSE,FALSE,"JR Smith",2747,15,2004,2019
"3808",FALSE,FALSE,"Jabari Smith",2074,4,2000,2004
"3809",TRUE,TRUE,"Jalen Smith",1630188,0,2020,2020
"3810",FALSE,FALSE,"Jason Smith",201160,11,2007,2018
"3811",FALSE,FALSE,"Jerry Smith",202536,0,2011,2011
"3812",FALSE,FALSE,"Jim Smith",78191,1,1981,1982
"3813",FALSE,FALSE,"Joe Smith",693,15,1995,2010
"3814",FALSE,FALSE,"Josh Smith",2746,13,2004,2017
"3815",FALSE,FALSE,"Keith Smith",78192,0,1986,1986
"3816",FALSE,FALSE,"Kenny Smith",181,9,1987,1996
"3817",FALSE,FALSE,"Labradford Smith",78194,2,1991,1993
"3818",FALSE,FALSE,"Larry Smith",78195,12,1980,1992
"3819",FALSE,FALSE,"Leon Smith",1910,2,2001,2003
"3820",FALSE,FALSE,"Michael Smith",63,6,1994,2000
"3821",FALSE,FALSE,"Michael Smith",78197,5,1989,1994
"3822",FALSE,FALSE,"Mike Smith",2065,0,2000,2000
"3823",FALSE,FALSE,"Nolan Smith",202701,1,2011,2012
"3824",FALSE,FALSE,"Otis Smith",78198,5,1986,1991
"3825",FALSE,FALSE,"Phil Smith",78199,8,1974,1982
"3826",FALSE,FALSE,"Randy Smith",78200,11,1971,1982
"3827",FALSE,FALSE,"Reggie Smith",78201,1,1992,1993
"3828",FALSE,FALSE,"Robert Smith",78204,7,1977,1984
"3829",FALSE,FALSE,"Russ Smith",203893,1,2014,2015
"3830",FALSE,FALSE,"Sammy Smith",78205,1,1978,1979
"3831",FALSE,FALSE,"Steven Smith",120,13,1991,2004
"3832",FALSE,FALSE,"Steven Smith",200848,0,2006,2006
"3833",FALSE,FALSE,"Stevin Smith",1478,0,1996,1996
"3834",FALSE,FALSE,"Theron Smith",2604,1,2003,2004
"3835",FALSE,FALSE,"Tony Smith",380,10,1990,2000
"3836",FALSE,FALSE,"Willie Smith",78208,3,1976,1979
"3837",FALSE,FALSE,"Zhaire Smith",1629015,1,2018,2019
"3838",TRUE,FALSE,"Dennis Smith Jr.",1628372,3,2017,2020
"3839",FALSE,FALSE,"Rik Smits",22,11,1988,1999
"3840",FALSE,FALSE,"Mike Smrek",1091,6,1985,1991
"3841",FALSE,FALSE,"Joe Smyth",78212,0,1953,1953
"3842",TRUE,FALSE,"Tony Snell",203503,7,2013,2020
"3843",FALSE,FALSE,"Eric Snow",727,12,1995,2007
"3844",FALSE,FALSE,"Dick Snyder",78213,12,1966,1978
"3845",FALSE,FALSE,"Kirk Snyder",2745,3,2004,2007
"3846",FALSE,FALSE,"George Sobek",78214,0,1949,1949
"3847",FALSE,FALSE,"Ricky Sobers",78215,10,1975,1985
"3848",FALSE,FALSE,"Ron Sobie",78216,3,1956,1959
"3849",FALSE,FALSE,"Mike Sojourner",78217,2,1974,1976
"3850",FALSE,FALSE,"Will Solomon",2226,7,2001,2008
"3851",FALSE,FALSE,"Willie Somerset",78219,0,1965,1965
"3852",FALSE,FALSE,"Darius Songaila",2443,7,2003,2010
"3853",FALSE,FALSE,"Dave Sorenson",78220,2,1970,1972
"3854",FALSE,FALSE,"James Southerland",203480,0,2013,2013
"3855",FALSE,FALSE,"Gino Sovran",78221,0,1946,1946
"3856",FALSE,FALSE,"Pape Sow",2776,2,2004,2006
"3857",FALSE,FALSE,"Ray Spalding",1629034,2,2018,2020
"3858",FALSE,FALSE,"Jim Spanarkel",78222,4,1979,1983
"3859",FALSE,FALSE,"Vassilis Spanoulis",2779,0,2006,2006
"3860",FALSE,FALSE,"Guy Sparrow",78223,2,1957,1959
"3861",FALSE,FALSE,"Rory Sparrow",600009,11,1980,1991
"3862",FALSE,FALSE,"Odie Spears",78225,8,1948,1956
"3863",FALSE,FALSE,"Art Spector",78226,3,1946,1949
"3864",FALSE,FALSE,"Marreese Speights",201578,9,2008,2017
"3865",FALSE,FALSE,"Omari Spellman",1629016,1,2018,2019
"3866",FALSE,FALSE,"Andre Spencer",78227,1,1992,1993
"3867",FALSE,FALSE,"Elmore Spencer",771,4,1992,1996
"3868",FALSE,FALSE,"Felton Spencer",280,11,1990,2001
"3869",FALSE,FALSE,"Lou Spicer",78230,0,1946,1946
"3870",FALSE,FALSE,"Craig Spitzer",78231,0,1967,1967
"3871",FALSE,FALSE,"Tiago Splitter",201168,6,2010,2016
"3872",FALSE,FALSE,"Art Spoelstra",78232,3,1954,1957
"3873",FALSE,FALSE,"Latrell Sprewell",84,12,1992,2004
"3874",FALSE,FALSE,"Larry Spriggs",78233,4,1981,1985
"3875",FALSE,FALSE,"Jim Springer",78234,0,1948,1948
"3876",FALSE,FALSE,"Jim Spruill",78235,0,1948,1948
"3877",FALSE,FALSE,"Ryan Stack",1756,1,1998,1999
"3878",FALSE,FALSE,"Jerry Stackhouse",711,17,1995,2012
"3879",FALSE,FALSE,"Kevin Stacom",78237,7,1974,1981
"3880",FALSE,FALSE,"Dave Stallworth",78238,9,1965,1974
"3881",FALSE,FALSE,"Isaac Stallworth",78239,4,1972,1976
"3882",FALSE,FALSE,"Ed Stanczak",78240,1,1949,1950
"3883",TRUE,TRUE,"Cassius Stanley",1630199,0,2020,2020
"3884",FALSE,FALSE,"Terence Stansbury",78241,2,1984,1986
"3885",FALSE,FALSE,"John Starks",317,13,1988,2001
"3886",FALSE,FALSE,"Keith Starr",78243,0,1976,1976
"3887",FALSE,FALSE,"Nik Stauskas",203917,4,2014,2018
"3888",FALSE,FALSE,"Larry Staverman",78244,5,1958,1963
"3889",FALSE,FALSE,"Larry Steele",78245,8,1971,1979
"3890",FALSE,FALSE,"Matt Steigenga",1099,0,1996,1996
"3891",FALSE,FALSE,"Vladimir Stepania",1735,5,1998,2003
"3892",FALSE,FALSE,"DJ Stephens",203474,5,2013,2018
"3893",FALSE,FALSE,"Everette Stephens",78247,2,1988,1990
"3894",FALSE,FALSE,"Jack Stephens",78249,0,1955,1955
"3895",FALSE,FALSE,"Joe Stephens",1086,3,1996,1999
"3896",FALSE,FALSE,"Lance Stephenson",202362,8,2010,2018
"3897",FALSE,FALSE,"Alex Stepheson",1627293,0,2015,2015
"3898",FALSE,FALSE,"Brook Steppe",78250,6,1982,1988
"3899",FALSE,FALSE,"Barry Stevens",78251,0,1992,1992
"3900",TRUE,TRUE,"Lamar Stevens",1630205,0,2020,2020
"3901",FALSE,FALSE,"Wayne Stevens",78252,0,1959,1959
"3902",FALSE,FALSE,"DeShawn Stevenson",2052,12,2000,2012
"3903",FALSE,FALSE,"Dennis Stewart",78253,0,1970,1970
"3904",TRUE,TRUE,"Isaiah Stewart",1630191,0,2020,2020
"3905",FALSE,FALSE,"Kebu Stewart",1529,0,1997,1997
"3906",FALSE,FALSE,"Larry Stewart",1125,5,1991,1996
"3907",FALSE,FALSE,"Michael Stewart",1565,7,1997,2004
"3908",FALSE,FALSE,"Norm Stewart",78256,0,1956,1956
"3909",FALSE,FALSE,"Greg Stiemsma",201880,5,2009,2014
"3910",FALSE,FALSE,"Steve Stipanovich",78257,4,1983,1987
"3911",FALSE,FALSE,"Bryant Stith",179,10,1992,2002
"3912",FALSE,FALSE,"Sam Stith",78259,0,1961,1961
"3913",FALSE,FALSE,"Tom Stith",78260,0,1962,1962
"3914",FALSE,FALSE,"Alex Stivrins",78261,7,1985,1992
"3915",FALSE,FALSE,"David Stockton",204065,3,2014,2017
"3916",FALSE,FALSE,"John Stockton",304,18,1984,2002
"3917",FALSE,FALSE,"Peja Stojakovic",978,12,1998,2010
"3918",FALSE,FALSE,"Ed Stokes",1055,0,1997,1997
"3919",FALSE,FALSE,"Greg Stokes",78264,4,1985,1989
"3920",FALSE,FALSE,"Jarnell Stokes",203950,2,2014,2016
"3921",FALSE,FALSE,"Maurice Stokes",600016,2,1955,1957
"3922",FALSE,FALSE,"Art Stolkey",78266,0,1946,1946
"3923",FALSE,FALSE,"Diamond Stone",1627754,0,2016,2016
"3924",FALSE,FALSE,"Julyan Stone",202933,6,2011,2017
"3925",FALSE,FALSE,"Awvee Storey",2852,3,2004,2007
"3926",FALSE,FALSE,"Damon Stoudamire",757,12,1995,2007
"3927",FALSE,FALSE,"Salim Stoudamire",101136,3,2005,2008
"3928",FALSE,FALSE,"Amar'e Stoudemire",2405,13,2002,2015
"3929",FALSE,FALSE,"Paul Stovall",78267,0,1972,1972
"3930",FALSE,FALSE,"DJ Strawberry",201199,0,2007,2007
"3931",FALSE,FALSE,"Joe Strawder",78268,2,1965,1967
"3932",FALSE,FALSE,"Bill Stricker",78269,0,1970,1970
"3933",FALSE,FALSE,"Erick Strickland",1065,8,1996,2004
"3934",FALSE,FALSE,"Mark Strickland",1110,8,1994,2002
"3935",FALSE,FALSE,"Rod Strickland",393,16,1988,2004
"3936",FALSE,FALSE,"Roger Strickland",78270,0,1963,1963
"3937",FALSE,FALSE,"John Stroeder",78271,1,1987,1988
"3938",FALSE,FALSE,"Derek Strong",400,9,1991,2000
"3939",FALSE,FALSE,"Lamont Strothers",78273,1,1991,1992
"3940",FALSE,FALSE,"John Stroud",78274,0,1980,1980
"3941",TRUE,FALSE,"Max Strus",1629622,1,2019,2020
"3942",FALSE,FALSE,"Rodney Stuckey",201155,9,2007,2016
"3943",FALSE,FALSE,"Gene Stump",78275,2,1947,1949
"3944",FALSE,FALSE,"Stan Stutz",78276,2,1946,1948
"3945",FALSE,FALSE,"Gary Suiter",78277,0,1970,1970
"3946",FALSE,FALSE,"Jared Sullinger",203096,4,2012,2016
"3947",FALSE,FALSE,"DaJuan Summers",201969,3,2009,2012
"3948",TRUE,FALSE,"Edmond Sumner",1628410,3,2017,2020
"3949",FALSE,FALSE,"Barry Sumpter",78654,0,1988,1988
"3950",FALSE,FALSE,"Sun Sun",201180,0,2008,2008
"3951",FALSE,FALSE,"Don Sunderlage",78278,1,1953,1954
"3952",FALSE,FALSE,"Bruno Sundov",1743,6,1998,2004
"3953",FALSE,FALSE,"Jon Sundvold",78279,8,1983,1991
"3954",FALSE,FALSE,"Bob Sura",682,11,1995,2006
"3955",FALSE,FALSE,"Dick Surhoff",78280,1,1952,1953
"3956",FALSE,FALSE,"Dane Suttle",78281,1,1983,1984
"3957",FALSE,FALSE,"Greg Sutton",357,4,1991,1995
"3958",FALSE,FALSE,"Bennie Swain",78283,0,1958,1958
"3959",FALSE,FALSE,"Caleb Swanigan",1628403,2,2017,2019
"3960",FALSE,FALSE,"Norm Swanson",78284,0,1953,1953
"3961",FALSE,FALSE,"Dan Swartz",78285,0,1962,1962
"3962",FALSE,FALSE,"Michael Sweetney",2552,3,2003,2006
"3963",FALSE,FALSE,"Robert Swift",2741,4,2004,2008
"3964",FALSE,FALSE,"Stromile Swift",2031,8,2000,2008
"3965",FALSE,FALSE,"Aaron Swinson",78286,0,1994,1994
"3966",FALSE,FALSE,"Pape Sy",202377,0,2010,2010
"3967",FALSE,FALSE,"Wallace Sydnor",78287,0,1946,1946
"3968",FALSE,FALSE,"Larry Sykes",1132,0,1995,1995
"3969",FALSE,FALSE,"Brett Szabo",1136,0,1996,1996
"3970",FALSE,FALSE,"Wally Szczerbiak",1887,9,1999,2008
"3971",FALSE,FALSE,"Zan Tabak",440,6,1994,2000
"3972",FALSE,FALSE,"Yuta Tabuse",2657,0,2004,2004
"3973",FALSE,FALSE,"Chris Taft",101147,0,2005,2005
"3974",FALSE,FALSE,"Sid Tannenbaum",78291,1,1947,1948
"3975",FALSE,FALSE,"Dragan Tarlac",1434,0,2000,2000
"3976",FALSE,FALSE,"Roy Tarpley",78293,8,1986,1994
"3977",TRUE,TRUE,"Jae'Sean Tate",1630256,0,2020,2020
"3978",FALSE,FALSE,"Earl Tatum",78294,3,1976,1979
"3979",TRUE,FALSE,"Jayson Tatum",1628369,3,2017,2020
"3980",FALSE,FALSE,"Edy Tavares",204002,1,2015,2016
"3981",FALSE,FALSE,"Anthony Taylor",78295,0,1988,1988
"3982",FALSE,FALSE,"Brian Taylor",78296,5,1976,1981
"3983",FALSE,FALSE,"Donell Taylor",101182,1,2005,2006
"3984",FALSE,FALSE,"Fred Taylor",78298,1,1970,1971
"3985",FALSE,FALSE,"Isaiah Taylor",1627819,1,2016,2017
"3986",FALSE,FALSE,"Jay Taylor",78297,0,1989,1989
"3987",FALSE,FALSE,"Jeff Taylor",78299,4,1982,1986
"3988",FALSE,FALSE,"Jeffery Taylor",203106,2,2012,2014
"3989",FALSE,FALSE,"Jermaine Taylor",201966,1,2009,2010
"3990",FALSE,FALSE,"Johnny Taylor",1511,2,1997,1999
"3991",FALSE,FALSE,"Leonard Taylor",78301,0,1989,1989
"3992",FALSE,FALSE,"Maurice Taylor",1508,9,1997,2006
"3993",FALSE,FALSE,"Mike Taylor",201446,0,2008,2008
"3994",FALSE,FALSE,"Roland Taylor",78302,0,1976,1976
"3995",FALSE,FALSE,"Tyshawn Taylor",203116,1,2012,2013
"3996",FALSE,FALSE,"Vince Taylor",78303,0,1982,1982
"3997",FALSE,FALSE,"Terry Teagle",78304,10,1982,1992
"3998",TRUE,FALSE,"Jeff Teague",201952,11,2009,2020
"3999",FALSE,FALSE,"Marquis Teague",203104,5,2012,2017
"4000",FALSE,FALSE,"Mirza Teletovic",203141,5,2012,2017
"4001",FALSE,FALSE,"Sebastian Telfair",2742,10,2004,2014
"4002",TRUE,FALSE,"Garrett Temple",202066,11,2009,2020
"4003",FALSE,FALSE,"Milos Teodosic",1628462,1,2017,2018
"4004",FALSE,FALSE,"Ira Terrell",78305,2,1976,1978
"4005",FALSE,FALSE,"Jared Terrell",1629123,0,2018,2018
"4006",FALSE,FALSE,"Carlos Terry",78307,2,1980,1982
"4007",FALSE,FALSE,"Chuck Terry",78306,4,1972,1976
"4008",FALSE,FALSE,"Claude Terry",78308,1,1976,1977
"4009",FALSE,FALSE,"Emanuel Terry",1629150,0,2018,2018
"4010",FALSE,FALSE,"Jason Terry",1891,18,1999,2017
"4011",TRUE,TRUE,"Tyrell Terry",1630179,0,2020,2020
"4012",FALSE,FALSE,"Hasheem Thabeet",201934,4,2009,2013
"4013",FALSE,FALSE,"Tom Thacker",78309,4,1963,1967
"4014",TRUE,FALSE,"Daniel Theis",1628464,3,2017,2020
"4015",FALSE,FALSE,"Reggie Theus",78310,12,1978,1990
"4016",FALSE,FALSE,"Peter Thibeaux",78311,1,1984,1985
"4017",FALSE,FALSE,"Bill Thieben",78312,1,1956,1957
"4018",FALSE,FALSE,"Justus Thigpen",78313,1,1972,1973
"4019",FALSE,FALSE,"David Thirdkill",78314,4,1982,1986
"4020",FALSE,FALSE,"Adonis Thomas",203519,0,2013,2013
"4021",FALSE,FALSE,"Billy Thomas",2873,3,2004,2007
"4022",TRUE,TRUE,"Brodric Thomas",1630271,0,2020,2020
"4023",FALSE,FALSE,"Carl Thomas",1063,6,1991,1997
"4024",FALSE,FALSE,"Charles Thomas",78316,0,1991,1991
"4025",FALSE,FALSE,"Etan Thomas",2041,9,2001,2010
"4026",FALSE,FALSE,"Irving Thomas",78317,0,1990,1990
"4027",FALSE,FALSE,"Isaiah Thomas",202738,9,2011,2020
"4028",FALSE,FALSE,"Isiah Thomas",78318,12,1981,1993
"4029",FALSE,FALSE,"Jamel Thomas",1975,1,1999,2000
"4030",FALSE,FALSE,"James Thomas",2839,1,2004,2005
"4031",FALSE,FALSE,"Jim Thomas",78320,7,1983,1990
"4032",FALSE,FALSE,"Joe Thomas",78321,0,1970,1970
"4033",FALSE,FALSE,"John Thomas",1519,8,1997,2005
"4034",FALSE,FALSE,"Kenny Thomas",1903,10,1999,2009
"4035",TRUE,FALSE,"Khyri Thomas",1629017,2,2018,2020
"4036",FALSE,FALSE,"Kurt Thomas",703,17,1995,2012
"4037",FALSE,FALSE,"Lance Thomas",202498,8,2011,2019
"4038",FALSE,FALSE,"Malcolm Thomas",202952,3,2011,2014
"4039",TRUE,FALSE,"Matt Thomas",1629744,1,2019,2020
"4040",FALSE,FALSE,"Terry Thomas",78322,0,1975,1975
"4041",FALSE,FALSE,"Tim Thomas",1501,12,1997,2009
"4042",FALSE,FALSE,"Tyrus Thomas",200748,8,2006,2014
"4043",FALSE,FALSE,"Trey Thompkins",202717,0,2011,2011
"4044",FALSE,FALSE,"Bernard Thompson",78323,4,1984,1988
"4045",FALSE,FALSE,"Billy Thompson",1631,5,1986,1991
"4046",FALSE,FALSE,"Brooks Thompson",240,3,1994,1997
"4047",FALSE,FALSE,"Corny Thompson",78325,0,1982,1982
"4048",FALSE,FALSE,"David Thompson",78326,7,1976,1983
"4049",FALSE,FALSE,"Dijon Thompson",101159,1,2005,2006
"4050",FALSE,FALSE,"George Thompson",78327,0,1974,1974
"4051",FALSE,FALSE,"Hollis Thompson",203138,3,2013,2016
"4052",FALSE,FALSE,"Jason Thompson",201574,7,2008,2015
"4053",FALSE,FALSE,"John Thompson",78328,1,1964,1965
"4054",FALSE,FALSE,"Kevin Thompson",78329,0,1993,1993
"4055",TRUE,FALSE,"Klay Thompson",202691,9,2011,2020
"4056",FALSE,FALSE,"LaSalle Thompson",78,14,1982,1996
"4057",FALSE,FALSE,"Mychal Thompson",78331,12,1978,1990
"4058",FALSE,FALSE,"Mychel Thompson",202814,0,2011,2011
"4059",FALSE,FALSE,"Paul Thompson",78332,2,1983,1985
"4060",FALSE,FALSE,"Stephen Thompson",78333,0,1991,1991
"4061",TRUE,FALSE,"Tristan Thompson",202684,9,2011,2020
"4062",FALSE,FALSE,"Rod Thorn",78335,7,1963,1970
"4063",FALSE,FALSE,"Al Thornton",201154,3,2007,2010
"4064",FALSE,FALSE,"Bob Thornton",738,10,1985,1995
"4065",FALSE,FALSE,"Marcus Thornton",201977,7,2009,2016
"4066",TRUE,FALSE,"Sindarius Thornwell",1628414,3,2017,2020
"4067",FALSE,FALSE,"Otis Thorpe",901,16,1984,2000
"4068",FALSE,FALSE,"Sedale Threatt",9,13,1983,1996
"4069",FALSE,FALSE,"Nate Thurmond",600001,13,1963,1976
"4070",FALSE,FALSE,"Mel Thurston",78340,0,1947,1947
"4071",TRUE,FALSE,"Matisse Thybulle",1629680,1,2019,2020
"4072",FALSE,FALSE,"Howard Tidrick",78341,0,1948,1948
"4073",FALSE,FALSE,"Dan Tieman",78342,0,1962,1962
"4074",TRUE,TRUE,"Killian Tillie",1629681,0,2020,2020
"4075",FALSE,FALSE,"Darren Tillis",78343,1,1982,1983
"4076",TRUE,TRUE,"Xavier Tillman",1630214,0,2020,2020
"4077",FALSE,FALSE,"Jack Tingle",78344,1,1947,1948
"4078",FALSE,FALSE,"Jamaal Tinsley",2224,12,2001,2013
"4079",FALSE,FALSE,"Wayman Tisdale",47,11,1985,1996
"4080",FALSE,FALSE,"Mike Tobey",1627861,0,2016,2016
"4081",FALSE,FALSE,"Marko Todorovich",78346,1,1949,1950
"4082",FALSE,FALSE,"Ray Tolbert",78348,7,1981,1988
"4083",FALSE,FALSE,"Tom Tolbert",78347,6,1988,1994
"4084",TRUE,FALSE,"Anthony Tolliver",201229,12,2008,2020
"4085",FALSE,FALSE,"Dean Tolson",78349,3,1974,1977
"4086",FALSE,FALSE,"Rudy Tomjanovich",78350,10,1970,1980
"4087",FALSE,FALSE,"Andrew Toney",78351,7,1980,1987
"4088",FALSE,FALSE,"Sedric Toney",78352,8,1985,1993
"4089",FALSE,FALSE,"Andy Tonkovich",78353,0,1948,1948
"4090",FALSE,FALSE,"Andy Toolson",342,5,1990,1995
"4091",FALSE,FALSE,"Jack Toomay",78355,2,1947,1949
"4092",FALSE,FALSE,"Bernard Toone",78356,0,1979,1979
"4093",TRUE,TRUE,"Obi Toppin",1630167,0,2020,2020
"4094",FALSE,FALSE,"Irv Torgoff",78357,2,1946,1948
"4095",FALSE,FALSE,"Gene Tormohlen",78358,7,1962,1969
"4096",FALSE,FALSE,"Oscar Torres",2351,1,2001,2002
"4097",TRUE,FALSE,"Juan Toscano-Anderson",1629308,1,2019,2020
"4098",FALSE,FALSE,"Bill Tosheff",78359,2,1951,1953
"4099",FALSE,FALSE,"Bob Tough",78360,1,1948,1949
"4100",TRUE,FALSE,"Axel Toupane",1626253,5,2015,2020
"4101",FALSE,FALSE,"Monte Towe",78361,0,1976,1976
"4102",FALSE,FALSE,"Keith Tower",700,3,1993,1996
"4103",FALSE,FALSE,"William Towery",78363,1,1948,1949
"4104",FALSE,FALSE,"Linton Townes",78364,2,1982,1984
"4105",TRUE,FALSE,"Karl-Anthony Towns",1626157,5,2015,2020
"4106",FALSE,FALSE,"Raymond Townsend",78365,3,1978,1981
"4107",FALSE,FALSE,"George Trapp",78366,5,1971,1976
"4108",FALSE,FALSE,"John Trapp",78367,4,1968,1972
"4109",FALSE,FALSE,"Robert Traylor",1714,6,1998,2004
"4110",FALSE,FALSE,"Gary Trent",718,8,1995,2003
"4111",TRUE,FALSE,"Gary Trent Jr.",1629018,2,2018,2020
"4112",FALSE,FALSE,"Jeff Trepagnier",2244,2,2001,2003
"4113",FALSE,FALSE,"John Tresvant",78651,8,1964,1972
"4114",FALSE,FALSE,"Allonzo Trier",1629019,1,2018,2019
"4115",FALSE,FALSE,"Dick Triptow",78368,1,1948,1949
"4116",FALSE,FALSE,"Kelly Tripucka",78369,9,1981,1990
"4117",FALSE,FALSE,"Cezary Trybanski",2456,1,2002,2003
"4118",FALSE,FALSE,"Jake Tsakalidis",2054,6,2000,2006
"4119",FALSE,FALSE,"John Tschogl",78370,2,1972,1974
"4120",FALSE,FALSE,"Lou Tsioropoulos",78371,2,1956,1958
"4121",FALSE,FALSE,"Nikoloz Tskitishvili",2401,3,2002,2005
"4122",FALSE,FALSE,"Al Tucker",78372,3,1967,1970
"4123",FALSE,FALSE,"Alando Tucker",201169,2,2007,2009
"4124",FALSE,FALSE,"Anthony Tucker",141,0,1994,1994
"4125",FALSE,FALSE,"Jim Tucker",78374,2,1954,1956
"4126",TRUE,FALSE,"P.J. Tucker",200782,14,2006,2020
"4127",TRUE,FALSE,"Rayjon Tucker",1629730,1,2019,2020
"4128",FALSE,FALSE,"Trent Tucker",78375,10,1982,1992
"4129",FALSE,FALSE,"Ronny Turiaf",101142,9,2005,2014
"4130",FALSE,FALSE,"Mirsad Turkcan",1726,0,1999,1999
"4131",FALSE,FALSE,"Hedo Turkoglu",2045,14,2000,2014
"4132",FALSE,FALSE,"Andre Turner",78377,5,1986,1991
"4133",FALSE,FALSE,"Bill Turner",78385,5,1967,1972
"4134",FALSE,FALSE,"Elston Turner",78378,7,1981,1988
"4135",FALSE,FALSE,"Evan Turner",202323,9,2010,2019
"4136",FALSE,FALSE,"Henry Turner",78379,5,1989,1994
"4137",FALSE,FALSE,"Jack Turner",78380,0,1954,1954
"4138",FALSE,FALSE,"Jack Turner",78382,0,1961,1961
"4139",FALSE,FALSE,"Jeff Turner",78381,11,1984,1995
"4140",FALSE,FALSE,"John Turner",1819,0,1991,1991
"4141",TRUE,FALSE,"Myles Turner",1626167,5,2015,2020
"4142",FALSE,FALSE,"Wayne Turner",1943,0,1999,1999
"4143",FALSE,FALSE,"Mel Turpin",78386,5,1984,1989
"4144",FALSE,FALSE,"Dave Twardzik",78387,3,1976,1979
"4145",FALSE,FALSE,"Jack Twyman",78388,10,1955,1965
"4146",FALSE,FALSE,"B.J. Tyler",189,0,1994,1994
"4147",FALSE,FALSE,"Jeremy Tyler",202719,2,2011,2013
"4148",FALSE,FALSE,"Terry Tyler",78390,10,1978,1988
"4149",FALSE,FALSE,"Charlie Tyra",78391,4,1957,1961
"4150",FALSE,FALSE,"Edwin Ubiles",202775,0,2011,2011
"4151",FALSE,FALSE,"Ekpe Udoh",202327,8,2010,2018
"4152",FALSE,FALSE,"Ime Udoka",2137,7,2003,2010
"4153",FALSE,FALSE,"Beno Udrih",2757,12,2004,2016
"4154",FALSE,FALSE,"Roko Ukic",101146,1,2008,2009
"4155",FALSE,FALSE,"Tyler Ulis",1627755,2,2016,2018
"4156",FALSE,FALSE,"Wes Unseld",78392,12,1968,1980
"4157",FALSE,FALSE,"Hal Uplinger",78393,0,1953,1953
"4158",FALSE,FALSE,"Kelvin Upshaw",78394,2,1988,1990
"4159",FALSE,FALSE,"Jarrod Uthoff",1627784,3,2016,2019
"4160",FALSE,FALSE,"Ben Uzoh",202386,1,2010,2011
"4161",FALSE,FALSE,"Robert Vaden",201987,0,2010,2010
"4162",TRUE,FALSE,"Jonas Valanciunas",202685,8,2012,2020
"4163",FALSE,FALSE,"Darnell Valentine",78395,9,1981,1990
"4164",TRUE,FALSE,"Denzel Valentine",1627756,4,2016,2020
"4165",FALSE,FALSE,"Ron Valentine",78396,0,1980,1980
"4166",FALSE,FALSE,"John Vallely",78397,1,1970,1971
"4167",FALSE,FALSE,"Dick Van Arsdale",78398,11,1965,1976
"4168",FALSE,FALSE,"Tom Van Arsdale",78399,11,1965,1976
"4169",FALSE,FALSE,"Butch Van Breda Kolff",78401,3,1946,1949
"4170",FALSE,FALSE,"Jan Van Breda Kolff",78400,6,1976,1982
"4171",FALSE,FALSE,"Nick Van Exel",89,12,1993,2005
"4172",FALSE,FALSE,"Keith Van Horn",1496,8,1997,2005
"4173",FALSE,FALSE,"Norm Van Lier",78406,9,1969,1978
"4174",TRUE,FALSE,"Fred VanVleet",1627832,4,2016,2020
"4175",FALSE,FALSE,"Gene Vance",78402,4,1947,1951
"4176",FALSE,FALSE,"Log Vander Velden",78403,0,1995,1995
"4177",TRUE,FALSE,"Jarred Vanderbilt",1629020,2,2018,2020
"4178",FALSE,FALSE,"Ernie Vandeweghe",78405,6,1949,1955
"4179",FALSE,FALSE,"Kiki Vandeweghe",78404,12,1980,1992
"4180",FALSE,FALSE,"Nick Vanos",78407,1,1985,1986
"4181",FALSE,FALSE,"David Vanterpool",2128,0,2000,2000
"4182",FALSE,FALSE,"Ratko Varda",2237,1,2001,2002
"4183",FALSE,FALSE,"Anderson Varejao",2760,16,2004,2020
"4184",FALSE,FALSE,"Jarvis Varnado",202363,1,2012,2013
"4185",FALSE,FALSE,"Greivis Vasquez",202349,6,2010,2016
"4186",TRUE,TRUE,"Devin Vassell",1630170,0,2020,2020
"4187",FALSE,FALSE,"Charles Vaughn",78409,4,1962,1966
"4188",FALSE,FALSE,"David Vaughn",710,3,1995,1998
"4189",FALSE,FALSE,"Jacque Vaughn",1521,11,1997,2008
"4190",FALSE,FALSE,"Rashad Vaughn",1626173,2,2015,2017
"4191",FALSE,FALSE,"Virgil Vaughn",78411,0,1946,1946
"4192",FALSE,FALSE,"Loy Vaught",919,10,1990,2000
"4193",FALSE,FALSE,"Bob Verga",78413,0,1973,1973
"4194",FALSE,FALSE,"Peter Verhoeven",78414,5,1981,1986
"4195",FALSE,FALSE,"Jan Vesely",202686,2,2011,2013
"4196",FALSE,FALSE,"Gundars Vetra",78415,0,1992,1992
"4197",FALSE,FALSE,"Joao Vianna",78416,0,1991,1991
"4198",TRUE,TRUE,"Luca Vildoza",1630492,0,2020,2020
"4199",FALSE,FALSE,"Charlie Villanueva",101111,10,2005,2015
"4200",TRUE,FALSE,"Gabe Vincent",1629216,1,2019,2020
"4201",FALSE,FALSE,"Jay Vincent",78418,8,1981,1989
"4202",FALSE,FALSE,"Sam Vincent",78417,6,1985,1991
"4203",FALSE,FALSE,"Marcus Vinicius",200790,1,2006,2007
"4204",FALSE,FALSE,"Fred Vinson",1844,5,1994,1999
"4205",FALSE,FALSE,"Gary Voce",78419,0,1989,1989
"4206",FALSE,FALSE,"Floyd Volker",78420,0,1949,1949
"4207",FALSE,FALSE,"Alexander Volkov",78421,2,1989,1991
"4208",FALSE,FALSE,"Whitey Von Nieda",78422,0,1949,1949
"4209",FALSE,FALSE,"Noah Vonleh",203943,6,2014,2020
"4210",FALSE,FALSE,"Jake Voskuhl",2063,8,2000,2008
"4211",FALSE,FALSE,"Danny Vranes",78423,6,1981,1987
"4212",FALSE,FALSE,"Slavko Vranes",2582,0,2003,2003
"4213",FALSE,FALSE,"Stojko Vrankovic",1037,8,1990,1998
"4214",FALSE,FALSE,"Brett Vroman",78425,0,1980,1980
"4215",FALSE,FALSE,"Jackson Vroman",2761,1,2004,2005
"4216",TRUE,FALSE,"Nikola Vucevic",202696,9,2011,2020
"4217",FALSE,FALSE,"Sasha Vujacic",2756,12,2004,2016
"4218",TRUE,FALSE,"Dean Wade",1629731,1,2019,2020
"4219",FALSE,FALSE,"Dwyane Wade",2548,15,2003,2018
"4220",FALSE,FALSE,"Mark Wade",78426,2,1987,1989
"4221",FALSE,FALSE,"Von Wafer",101144,6,2005,2011
"4222",FALSE,FALSE,"Clint Wager",78427,0,1949,1949
"4223",FALSE,FALSE,"Dajuan Wagner",2402,4,2002,2006
"4224",FALSE,FALSE,"Danny Wagner",78428,0,1949,1949
"4225",FALSE,FALSE,"Milt Wagner",78429,3,1987,1990
"4226",TRUE,FALSE,"Moritz Wagner",1629021,2,2018,2020
"4227",FALSE,FALSE,"Dion Waiters",203079,7,2012,2019
"4228",FALSE,FALSE,"Granville Waiters",78430,4,1983,1987
"4229",FALSE,FALSE,"Andre Wakefield",78431,1,1978,1979
"4230",FALSE,FALSE,"Neal Walk",78432,7,1969,1976
"4231",FALSE,FALSE,"Andy Walker",78433,0,1976,1976
"4232",FALSE,FALSE,"Antoine Walker",952,11,1996,2007
"4233",FALSE,FALSE,"Brady Walker",78434,3,1948,1951
"4234",FALSE,FALSE,"Chet Walker",78435,12,1962,1974
"4235",FALSE,FALSE,"Darrell Walker",78437,9,1983,1992
"4236",FALSE,FALSE,"Foots Walker",78436,9,1974,1983
"4237",FALSE,FALSE,"Henry Walker",201611,6,2008,2014
"4238",FALSE,FALSE,"Horace Walker",78438,0,1961,1961
"4239",FALSE,FALSE,"Jimmy Walker",78439,8,1967,1975
"4240",TRUE,FALSE,"Kemba Walker",202689,9,2011,2020
"4241",FALSE,FALSE,"Kenny Walker",78440,8,1986,1994
"4242",FALSE,FALSE,"Phil Walker",78441,0,1977,1977
"4243",FALSE,FALSE,"Samaki Walker",955,9,1996,2005
"4244",FALSE,FALSE,"Wally Walker",78442,7,1976,1983
"4245",TRUE,FALSE,"Lonnie Walker IV",1629022,2,2018,2020
"4246",TRUE,FALSE,"John Wall",202322,10,2010,2020
"4247",FALSE,FALSE,"Ben Wallace",1112,15,1996,2011
"4248",FALSE,FALSE,"Gerald Wallace",2222,13,2001,2014
"4249",FALSE,FALSE,"John Wallace",961,7,1996,2003
"4250",FALSE,FALSE,"Michael Wallace",78443,0,1946,1946
"4251",FALSE,FALSE,"Rasheed Wallace",739,17,1995,2012
"4252",FALSE,FALSE,"Tyrone Wallace",1627820,2,2017,2019
"4253",FALSE,FALSE,"Dwight Waller",78444,0,1968,1968
"4254",FALSE,FALSE,"Jamie Waller",78445,0,1987,1987
"4255",FALSE,FALSE,"Jim Walsh",78446,0,1957,1957
"4256",FALSE,FALSE,"Matt Walsh",101190,0,2005,2005
"4257",FALSE,FALSE,"Rex Walters",777,6,1993,1999
"4258",FALSE,FALSE,"Paul Walther",78447,5,1949,1954
"4259",FALSE,FALSE,"Rabbit Walthour",78448,0,1953,1953
"4260",FALSE,FALSE,"Bill Walton",78450,12,1974,1986
"4261",FALSE,FALSE,"Lloyd Walton",78449,4,1976,1980
"4262",FALSE,FALSE,"Luke Walton",2575,9,2003,2012
"4263",FALSE,FALSE,"Derrick Walton Jr.",1628476,2,2017,2019
"4264",TRUE,FALSE,"Brad Wanamaker",202954,2,2018,2020
"4265",FALSE,FALSE,"Bobby Wanzer",78453,8,1948,1956
"4266",FALSE,FALSE,"Perry Warbington",78454,0,1974,1974
"4267",FALSE,FALSE,"Charlie Ward",369,10,1994,2004
"4268",FALSE,FALSE,"Gerry Ward",78455,3,1963,1966
"4269",FALSE,FALSE,"Henry Ward",78456,0,1976,1976
"4270",FALSE,FALSE,"Casper Ware",203810,0,2013,2013
"4271",FALSE,FALSE,"Jim Ware",78457,1,1966,1967
"4272",FALSE,FALSE,"Ben Warley",78458,4,1962,1966
"4273",FALSE,FALSE,"Bob Warlick",78459,3,1965,1968
"4274",FALSE,FALSE,"Cornell Warner",78460,6,1970,1976
"4275",FALSE,FALSE,"Jameel Warney",1627866,0,2017,2017
"4276",FALSE,FALSE,"Johnny Warren",78461,4,1969,1973
"4277",TRUE,FALSE,"T.J. Warren",203933,6,2014,2020
"4278",FALSE,FALSE,"Willie Warren",202378,0,2010,2010
"4279",FALSE,FALSE,"Bryan Warrick",78462,3,1982,1985
"4280",FALSE,FALSE,"Hakim Warrick",101124,7,2005,2012
"4281",FALSE,FALSE,"Chris Washburn",78463,1,1986,1987
"4282",FALSE,FALSE,"Julian Washburn",1627395,0,2018,2018
"4283",FALSE,FALSE,"Bobby Washington",78469,1,1970,1971
"4284",FALSE,FALSE,"Darius Washington",200827,0,2007,2007
"4285",FALSE,FALSE,"Duane Washington",78464,5,1987,1992
"4286",FALSE,FALSE,"Dwayne Washington",78465,2,1986,1988
"4287",FALSE,FALSE,"Eric Washington",1540,1,1997,1998
"4288",FALSE,FALSE,"Jim Washington",78466,10,1965,1975
"4289",FALSE,FALSE,"Kermit Washington",78467,14,1973,1987
"4290",TRUE,FALSE,"P.J. Washington",1629023,1,2019,2020
"4291",FALSE,FALSE,"Richard Washington",78468,5,1976,1981
"4292",FALSE,FALSE,"Stan Washington",78470,0,1974,1974
"4293",FALSE,FALSE,"Wilson Washington",78471,1,1977,1978
"4294",TRUE,FALSE,"Yuta Watanabe",1629139,2,2018,2020
"4295",TRUE,FALSE,"Tremont Waters",1629682,1,2019,2020
"4296",FALSE,FALSE,"Darryl Watkins",201208,4,2007,2011
"4297",FALSE,FALSE,"C.J. Watson",201228,9,2007,2016
"4298",FALSE,FALSE,"Earl Watson",2248,12,2001,2013
"4299",FALSE,FALSE,"Jamie Watson",320,4,1994,1998
"4300",TRUE,FALSE,"Paul Watson",1628778,1,2019,2020
"4301",FALSE,FALSE,"Ron Watts",78474,1,1965,1966
"4302",FALSE,FALSE,"Slick Watts",78473,5,1973,1978
"4303",FALSE,FALSE,"Maalik Wayns",203146,1,2012,2013
"4304",FALSE,FALSE,"David Wear",204033,0,2014,2014
"4305",FALSE,FALSE,"Travis Wear",204037,3,2014,2017
"4306",FALSE,FALSE,"Clar. Weatherspoon",221,12,1992,2004
"4307",FALSE,FALSE,"Nick Weatherspoon",78475,6,1973,1979
"4308",TRUE,FALSE,"Quinndary Weatherspoon",1629683,1,2019,2020
"4309",FALSE,FALSE,"Kyle Weaver",201602,2,2008,2010
"4310",FALSE,FALSE,"Jeff Webb",78477,1,1970,1971
"4311",FALSE,FALSE,"Marcus Webb",78478,0,1992,1992
"4312",FALSE,FALSE,"Spud Webb",892,12,1985,1997
"4313",FALSE,FALSE,"James Webb III",1627821,0,2017,2017
"4314",FALSE,FALSE,"Chris Webber",185,14,1993,2007
"4315",FALSE,FALSE,"Briante Weber",1627362,2,2015,2017
"4316",FALSE,FALSE,"Forest Weber",78479,0,1946,1946
"4317",FALSE,FALSE,"Jeff Webster",1067,0,1995,1995
"4318",FALSE,FALSE,"Martell Webster",101110,9,2005,2014
"4319",FALSE,FALSE,"Marvin Webster",78481,10,1976,1986
"4320",FALSE,FALSE,"Scott Wedman",78482,12,1974,1986
"4321",FALSE,FALSE,"Sonny Weems",201603,7,2008,2015
"4322",FALSE,FALSE,"Dick Wehr",78483,0,1948,1948
"4323",FALSE,FALSE,"Brant Weidner",78484,0,1983,1983
"4324",FALSE,FALSE,"Bob Weiss",78485,11,1965,1976
"4325",FALSE,FALSE,"Rick Weitzman",78486,0,1967,1967
"4326",FALSE,FALSE,"Bonzi Wells",1719,9,1998,2007
"4327",FALSE,FALSE,"Bubba Wells",1528,0,1997,1997
"4328",FALSE,FALSE,"Owen Wells",78488,0,1974,1974
"4329",FALSE,FALSE,"Ralph Wells",78489,0,1962,1962
"4330",FALSE,FALSE,"Chris Welp",1846,2,1987,1989
"4331",FALSE,FALSE,"Jiri Welsch",2412,3,2002,2005
"4332",FALSE,FALSE,"Thomas Welsh",1629118,0,2018,2018
"4333",FALSE,FALSE,"Bill Wennington",82,14,1985,1999
"4334",FALSE,FALSE,"Matt Wenstrom",78492,0,1993,1993
"4335",FALSE,FALSE,"Robert Werdann",438,4,1992,1996
"4336",FALSE,FALSE,"Ray Wertis",78494,1,1946,1947
"4337",FALSE,FALSE,"David Wesley",133,13,1993,2006
"4338",FALSE,FALSE,"Walt Wesley",78495,9,1966,1975
"4339",FALSE,FALSE,"David West",2561,14,2003,2017
"4340",FALSE,FALSE,"Delonte West",2753,7,2004,2011
"4341",FALSE,FALSE,"Doug West",28,11,1989,2000
"4342",FALSE,FALSE,"Jerry West",78497,13,1960,1973
"4343",FALSE,FALSE,"Mario West",201238,3,2007,2010
"4344",FALSE,FALSE,"Mark West",770,16,1983,1999
"4345",FALSE,FALSE,"Roland West",78499,0,1967,1967
"4346",TRUE,FALSE,"Russell Westbrook",201566,12,2008,2020
"4347",FALSE,FALSE,"Paul Westphal",78500,11,1972,1983
"4348",FALSE,FALSE,"John Wetzel",78501,8,1967,1975
"4349",FALSE,FALSE,"Robert Whaley",101156,0,2005,2005
"4350",FALSE,FALSE,"Ennis Whatley",941,13,1983,1996
"4351",FALSE,FALSE,"DeJuan Wheat",1545,1,1997,1998
"4352",FALSE,FALSE,"Clinton Wheeler",78504,1,1987,1988
"4353",FALSE,FALSE,"Tyson Wheeler",1755,0,1998,1998
"4354",FALSE,FALSE,"Lucian Whitaker",78506,0,1954,1954
"4355",TRUE,FALSE,"Coby White",1629632,1,2019,2020
"4356",FALSE,FALSE,"DJ White",201591,5,2008,2013
"4357",TRUE,FALSE,"Derrick White",1628401,3,2017,2020
"4358",FALSE,FALSE,"Eric White",78507,1,1987,1988
"4359",FALSE,FALSE,"Herb White",78508,0,1970,1970
"4360",FALSE,FALSE,"Hubie White",78509,1,1962,1963
"4361",FALSE,FALSE,"Jahidi White",1751,6,1998,2004
"4362",FALSE,FALSE,"James White",200778,6,2006,2012
"4363",FALSE,FALSE,"Jojo White",78510,11,1969,1980
"4364",FALSE,FALSE,"Okaro White",1627855,2,2016,2018
"4365",FALSE,FALSE,"Randy White",1839,4,1989,1993
"4366",FALSE,FALSE,"Rodney White",2206,3,2001,2004
"4367",FALSE,FALSE,"Rory White",78512,4,1982,1986
"4368",FALSE,FALSE,"Royce White",203091,1,2012,2013
"4369",FALSE,FALSE,"Rudy White",78513,5,1975,1980
"4370",FALSE,FALSE,"Terrico White",202358,0,2010,2010
"4371",FALSE,FALSE,"Tony White",78514,0,1987,1987
"4372",FALSE,FALSE,"Willie White",78515,1,1984,1985
"4373",FALSE,FALSE,"Andrew White III",1628510,0,2017,2017
"4374",FALSE,FALSE,"Isaiah Whitehead",1627785,2,2016,2018
"4375",FALSE,FALSE,"Jerome Whitehead",78516,10,1978,1988
"4376",FALSE,FALSE,"Donald Whiteside",1126,1,1996,1997
"4377",TRUE,FALSE,"Hassan Whiteside",202355,10,2010,2020
"4378",FALSE,FALSE,"Dwayne Whitfield",730,0,1995,1995
"4379",FALSE,FALSE,"Charles Whitney",78519,1,1980,1981
"4380",FALSE,FALSE,"Chris Whitney",43,10,1993,2003
"4381",FALSE,TRUE,"Greg Whittington",204222,0,2020,2020
"4382",FALSE,FALSE,"Shayne Whittington",203963,1,2014,2015
"4383",FALSE,FALSE,"Sidney Wicks",78520,9,1971,1980
"4384",FALSE,FALSE,"Murray Wier",78521,0,1949,1949
"4385",FALSE,FALSE,"Bob Wiesenhahn",78522,0,1961,1961
"4386",TRUE,FALSE,"Andrew Wiggins",203952,6,2014,2020
"4387",FALSE,FALSE,"Mitchell Wiggins",78523,8,1983,1991
"4388",FALSE,FALSE,"Ken Wilburn",78524,1,1967,1968
"4389",FALSE,FALSE,"C.J. Wilcox",203912,3,2014,2017
"4390",FALSE,FALSE,"Chris Wilcox",2404,10,2002,2012
"4391",FALSE,FALSE,"D.C. Wilcutt",78525,1,1948,1949
"4392",FALSE,FALSE,"Gene Wiley",78526,3,1962,1965
"4393",FALSE,FALSE,"Jacob Wiley",1628451,0,2017,2017
"4394",FALSE,FALSE,"Michael Wiley",78527,1,1980,1981
"4395",FALSE,FALSE,"Morlon Wiley",78528,6,1988,1994
"4396",FALSE,FALSE,"Win Wilfong",78529,3,1957,1960
"4397",FALSE,FALSE,"Lenny Wilkens",78530,14,1960,1974
"4398",FALSE,FALSE,"Bob Wilkerson",78531,6,1976,1982
"4399",FALSE,FALSE,"Jamaal Wilkes",78532,11,1974,1985
"4400",FALSE,FALSE,"James Wilkes",78533,2,1980,1982
"4401",FALSE,FALSE,"Damien Wilkins",2863,13,2004,2017
"4402",FALSE,FALSE,"Dominique Wilkins",1122,16,1982,1998
"4403",FALSE,FALSE,"Eddielee Wilkins",78534,8,1984,1992
"4404",FALSE,FALSE,"Gerald Wilkins",786,13,1985,1998
"4405",FALSE,FALSE,"Jeff Wilkins",78537,5,1980,1985
"4406",FALSE,FALSE,"Dale Wilkinson",78538,0,1984,1984
"4407",FALSE,FALSE,"Mike Wilks",2366,7,2002,2009
"4408",FALSE,FALSE,"Aaron Williams",1425,14,1993,2007
"4409",FALSE,FALSE,"Alan Williams",1626210,3,2015,2018
"4410",FALSE,FALSE,"Alvin Williams",1541,9,1997,2006
"4411",FALSE,FALSE,"Arthur Williams",78539,6,1967,1973
"4412",FALSE,FALSE,"Bernie Williams",78540,1,1969,1970
"4413",FALSE,FALSE,"Bob Williams",78564,1,1955,1956
"4414",FALSE,FALSE,"Brandon Williams",1585,5,1997,2002
"4415",FALSE,FALSE,"Buck Williams",433,16,1981,1997
"4416",FALSE,FALSE,"C.J. Williams",203710,1,2017,2018
"4417",FALSE,FALSE,"Chuck Williams",78547,1,1976,1977
"4418",FALSE,FALSE,"Chuckie Williams",78541,0,1976,1976
"4419",FALSE,FALSE,"Cliff Williams",78543,0,1968,1968
"4420",FALSE,FALSE,"Corey Williams",101258,1,1992,1993
"4421",FALSE,FALSE,"Deron Williams",101114,11,2005,2016
"4422",FALSE,FALSE,"Derrick Williams",202682,6,2011,2017
"4423",FALSE,FALSE,"Don Williams",78545,0,1979,1979
"4424",FALSE,FALSE,"Earl Williams",78546,4,1974,1978
"4425",FALSE,FALSE,"Elliot Williams",202343,5,2010,2015
"4426",FALSE,FALSE,"Eric Williams",677,11,1995,2006
"4427",FALSE,FALSE,"Frank Williams",2421,2,2002,2004
"4428",FALSE,FALSE,"Freeman Williams",78548,7,1978,1985
"4429",TRUE,FALSE,"Grant Williams",1629684,1,2019,2020
"4430",FALSE,FALSE,"Gus Williams",78549,11,1975,1986
"4431",FALSE,FALSE,"Guy Williams",78550,1,1984,1985
"4432",FALSE,FALSE,"Herb Williams",1006,17,1981,1998
"4433",FALSE,FALSE,"Hot Rod Williams",73,12,1986,1998
"4434",FALSE,FALSE,"Jason Williams",1715,12,1998,2010
"4435",FALSE,FALSE,"Jawad Williams",101214,2,2008,2010
"4436",FALSE,FALSE,"Jay Williams",2398,0,2002,2002
"4437",FALSE,FALSE,"Jayson Williams",420,8,1990,1998
"4438",FALSE,FALSE,"Jerome Williams",966,8,1996,2004
"4439",FALSE,FALSE,"John Williams",78554,8,1986,1994
"4440",FALSE,FALSE,"Johnathan Williams",1629140,1,2018,2019
"4441",FALSE,FALSE,"Jordan Williams",202716,0,2011,2011
"4442",FALSE,FALSE,"Justin Williams",200818,1,2006,2007
"4443",FALSE,FALSE,"Kenny Williams",78555,3,1990,1993
"4444",TRUE,FALSE,"Kenrich Williams",1629026,2,2018,2020
"4445",FALSE,FALSE,"Kevin Williams",78556,5,1983,1988
"4446",FALSE,FALSE,"Lorenzo Williams",31,7,1992,1999
"4447",TRUE,FALSE,"Lou Williams",101150,15,2005,2020
"4448",FALSE,FALSE,"Marcus Williams",200766,3,2006,2009
"4449",FALSE,FALSE,"Marcus Williams",201173,1,2007,2008
"4450",FALSE,FALSE,"Marvin Williams",101107,14,2005,2019
"4451",FALSE,FALSE,"Micheal Williams",52,10,1988,1998
"4452",FALSE,FALSE,"Mike Williams",78558,0,1989,1989
"4453",FALSE,FALSE,"Milt Williams",78560,3,1970,1973
"4454",FALSE,FALSE,"Mo Williams",2590,12,2003,2015
"4455",FALSE,FALSE,"Monty Williams",42,8,1994,2002
"4456",FALSE,FALSE,"Nate Williams",78561,7,1971,1978
"4457",TRUE,TRUE,"Patrick Williams",1630172,0,2020,2020
"4458",FALSE,FALSE,"Pete Williams",78566,1,1985,1986
"4459",FALSE,FALSE,"Ray Williams",78571,9,1977,1986
"4460",FALSE,FALSE,"Reggie Williams",199,9,1987,1996
"4461",FALSE,FALSE,"Reggie Williams",202130,7,2009,2016
"4462",FALSE,FALSE,"Rickey Williams",78563,0,1982,1982
"4463",FALSE,FALSE,"Rob Williams",78565,1,1982,1983
"4464",FALSE,FALSE,"Ron Williams",78567,7,1968,1975
"4465",FALSE,FALSE,"Sam Williams",78568,1,1968,1969
"4466",FALSE,FALSE,"Samuel Williams",78569,3,1981,1984
"4467",FALSE,FALSE,"Scott Williams",281,14,1990,2004
"4468",FALSE,FALSE,"Sean Williams",201157,4,2007,2011
"4469",FALSE,FALSE,"Shammond Williams",1742,8,1998,2006
"4470",FALSE,FALSE,"Shawne Williams",200761,8,2006,2014
"4471",FALSE,FALSE,"Shelden Williams",200749,5,2006,2011
"4472",FALSE,FALSE,"Sly Williams",78570,6,1979,1985
"4473",FALSE,FALSE,"Terrence Williams",201944,3,2009,2012
"4474",FALSE,FALSE,"Travis Williams",1576,1,1997,1998
"4475",FALSE,FALSE,"Troy Williams",1627786,2,2016,2018
"4476",FALSE,FALSE,"Walt Williams",1005,10,1992,2002
"4477",FALSE,FALSE,"Ward Williams",78573,0,1948,1948
"4478",FALSE,FALSE,"Willie Williams",78574,0,1970,1970
"4479",TRUE,FALSE,"Robert Williams III",1629057,2,2018,2020
"4480",FALSE,FALSE,"Matt Williams Jr.",1628475,0,2017,2017
"4481",FALSE,FALSE,"Nigel Williams-Goss",1628430,0,2019,2019
"4482",FALSE,FALSE,"Corliss Williamson",722,11,1995,2006
"4483",FALSE,FALSE,"John Williamson",78575,4,1976,1980
"4484",TRUE,FALSE,"Zion Williamson",1629627,1,2019,2020
"4485",FALSE,FALSE,"Kevin Willis",788,22,1984,2006
"4486",FALSE,FALSE,"Bill Willoughby",78577,8,1975,1983
"4487",FALSE,FALSE,"Dedric Willoughby",2000,0,1999,1999
"4488",FALSE,FALSE,"Bob Wilson",78586,0,1951,1951
"4489",FALSE,FALSE,"Bobby Wilson",78585,3,1974,1977
"4490",TRUE,FALSE,"D.J. Wilson",1628391,3,2017,2020
"4491",FALSE,FALSE,"George Wilson",78579,6,1964,1970
"4492",FALSE,FALSE,"Isaiah Wilson",78580,0,1971,1971
"4493",FALSE,FALSE,"Jamil Wilson",203966,0,2017,2017
"4494",FALSE,FALSE,"Mike Wilson",78581,3,1983,1986
"4495",FALSE,FALSE,"Nikita Wilson",78582,0,1987,1987
"4496",FALSE,FALSE,"Othell Wilson",78578,2,1984,1986
"4497",FALSE,FALSE,"Rick Wilson",78583,1,1978,1979
"4498",FALSE,FALSE,"Ricky Wilson",78584,0,1987,1987
"4499",FALSE,FALSE,"Thomas Wilson",78587,0,1979,1979
"4500",FALSE,FALSE,"Trevor Wilson",1027,5,1990,1995
"4501",FALSE,FALSE,"Kyle Wiltjer",1627787,0,2016,2016
"4502",FALSE,FALSE,"Kennard Winchester",78589,2,1990,1992
"4503",FALSE,FALSE,"Tony Windis",78590,0,1959,1959
"4504",TRUE,FALSE,"Dylan Windler",1629685,1,2019,2020
"4505",FALSE,FALSE,"John Windsor",78591,0,1963,1963
"4506",FALSE,FALSE,"Lee Winfield",78592,6,1969,1975
"4507",FALSE,FALSE,"David Wingate",766,14,1986,2000
"4508",FALSE,FALSE,"Dontonio Wingfield",112,3,1994,1997
"4509",FALSE,FALSE,"Harthorne Wingo",78596,3,1972,1975
"4510",FALSE,FALSE,"Marv Winkler",78597,0,1970,1970
"4511",TRUE,FALSE,"Justise Winslow",1626159,5,2015,2020
"4512",FALSE,FALSE,"Rickie Winslow",1984,0,1987,1987
"4513",TRUE,TRUE,"Cassius Winston",1630216,0,2020,2020
"4514",FALSE,FALSE,"Trevor Winter",1868,0,1998,1998
"4515",FALSE,FALSE,"Brian Winters",78600,8,1974,1982
"4516",FALSE,FALSE,"Voise Winters",78601,0,1985,1985
"4517",FALSE,FALSE,"Willie Wise",78602,1,1976,1977
"4518",TRUE,TRUE,"James Wiseman",1630164,0,2020,2020
"4519",FALSE,FALSE,"Jeff Withey",203481,4,2013,2017
"4520",FALSE,FALSE,"Luke Witte",78603,2,1973,1975
"4521",FALSE,FALSE,"Randy Wittman",1456,8,1983,1991
"4522",FALSE,FALSE,"Garry Witts",78605,0,1981,1981
"4523",FALSE,FALSE,"Dave Wohl",78606,6,1971,1977
"4524",FALSE,FALSE,"Joe Wolf",341,11,1987,1998
"4525",FALSE,FALSE,"Ruben Wolkowyski",2106,2,2000,2002
"4526",FALSE,FALSE,"Nate Wolters",203489,4,2013,2017
"4527",FALSE,FALSE,"Al Wood",78610,5,1981,1986
"4528",FALSE,FALSE,"Bob Wood",78612,0,1949,1949
"4529",TRUE,FALSE,"Christian Wood",1626174,5,2015,2020
"4530",FALSE,FALSE,"David Wood",116,8,1988,1996
"4531",FALSE,FALSE,"Howard Wood",78609,0,1981,1981
"4532",FALSE,FALSE,"Leon Wood",78611,6,1984,1990
"4533",TRUE,TRUE,"Robert Woodard II",1630218,0,2020,2020
"4534",FALSE,FALSE,"Loren Woods",2254,6,2001,2007
"4535",FALSE,FALSE,"Qyntel Woods",2417,3,2002,2005
"4536",FALSE,FALSE,"Randy Woods",1010,3,1992,1995
"4537",FALSE,FALSE,"Mike Woodson",78614,10,1980,1990
"4538",FALSE,FALSE,"Orlando Woolridge",78615,12,1981,1993
"4539",FALSE,FALSE,"Kenny Wooten",1629624,0,2019,2019
"4540",FALSE,FALSE,"Haywoode Workman",906,10,1989,1999
"4541",FALSE,FALSE,"Mark Workman",78616,1,1952,1953
"4542",FALSE,FALSE,"Tom Workman",78617,2,1967,1969
"4543",FALSE,FALSE,"Metta World Peace",1897,17,1999,2016
"4544",FALSE,FALSE,"Sam Worthen",78618,1,1980,1981
"4545",FALSE,FALSE,"James Worthy",1460,11,1982,1993
"4546",FALSE,FALSE,"Antoine Wright",101120,5,2005,2010
"4547",FALSE,FALSE,"Bracey Wright",101152,1,2005,2006
"4548",FALSE,FALSE,"Brad Wright",78620,1,1986,1987
"4549",FALSE,FALSE,"Brandan Wright",201148,10,2007,2017
"4550",FALSE,FALSE,"Chris Wright",202874,2,2011,2013
"4551",FALSE,FALSE,"Chris Wright",203203,0,2012,2012
"4552",TRUE,FALSE,"Delon Wright",1626153,5,2015,2020
"4553",FALSE,FALSE,"Dorell Wright",2748,11,2004,2015
"4554",FALSE,FALSE,"Howard Wright",78621,2,1990,1992
"4555",FALSE,FALSE,"Joby Wright",78622,0,1972,1972
"4556",FALSE,FALSE,"Julian Wright",201153,3,2007,2010
"4557",FALSE,FALSE,"Larry Wright",78623,5,1976,1981
"4558",FALSE,FALSE,"Lorenzen Wright",953,12,1996,2008
"4559",FALSE,FALSE,"Luther Wright",1007,0,1993,1993
"4560",FALSE,FALSE,"Sharone Wright",412,3,1994,1997
"4561",FALSE,FALSE,"Justin Wright-Foreman",1629625,0,2019,2019
"4562",FALSE,FALSE,"Tony Wroten",203100,3,2012,2015
"4563",FALSE,FALSE,"A.J. Wynder",78627,0,1990,1990
"4564",FALSE,FALSE,"Guerschon Yabusele",1627824,1,2017,2018
"4565",FALSE,FALSE,"Yao Ming",2397,8,2002,2010
"4566",FALSE,FALSE,"Vincent Yarbrough",2428,0,2002,2002
"4567",FALSE,FALSE,"George Yardley",78628,6,1953,1959
"4568",FALSE,FALSE,"Barry Yates",78629,0,1971,1971
"4569",FALSE,FALSE,"Wayne Yates",78630,0,1961,1961
"4570",FALSE,FALSE,"Charlie Yelverton",78631,0,1971,1971
"4571",FALSE,FALSE,"Yi Jianlian",201146,4,2007,2011
"4572",FALSE,FALSE,"Rich Yonakor",78632,0,1981,1981
"4573",FALSE,FALSE,"Danny Young",78633,10,1984,1994
"4574",FALSE,FALSE,"James Young",203923,3,2014,2017
"4575",FALSE,FALSE,"Joe Young",1626202,2,2015,2017
"4576",FALSE,FALSE,"Korleone Young",1748,0,1998,1998
"4577",FALSE,FALSE,"Michael Young",78634,5,1984,1989
"4578",FALSE,FALSE,"Nick Young",201156,11,2007,2018
"4579",FALSE,FALSE,"Perry Young",78635,0,1986,1986
"4580",FALSE,FALSE,"Sam Young",201970,3,2009,2012
"4581",TRUE,FALSE,"Thaddeus Young",201152,13,2007,2020
"4582",FALSE,FALSE,"Tim Young",1937,0,1999,1999
"4583",TRUE,FALSE,"Trae Young",1629027,2,2018,2020
"4584",TRUE,TRUE,"Omer Yurtseven",1630209,0,2020,2020
"4585",FALSE,FALSE,"Max Zaslofsky",78638,9,1946,1955
"4586",FALSE,FALSE,"Robert Zawoluk",78639,2,1952,1954
"4587",TRUE,FALSE,"Cody Zeller",203469,7,2013,2020
"4588",FALSE,FALSE,"Dave Zeller",78640,0,1961,1961
"4589",FALSE,FALSE,"Gary Zeller",78641,1,1970,1971
"4590",FALSE,FALSE,"Hank Zeller",78642,0,1946,1946
"4591",FALSE,FALSE,"Luke Zeller",202545,0,2012,2012
"4592",FALSE,FALSE,"Tyler Zeller",203092,7,2012,2019
"4593",FALSE,FALSE,"Tony Zeno",78643,0,1979,1979
"4594",FALSE,FALSE,"Phil Zevenbergen",78644,0,1987,1987
"4595",FALSE,FALSE,"Wang Zhi-zhi",1917,4,2000,2004
"4596",FALSE,FALSE,"George Zidek",678,2,1995,1997
"4597",FALSE,FALSE,"Derrick Zimmerman",2583,0,2005,2005
"4598",FALSE,FALSE,"Stephen Zimmerman",1627757,0,2016,2016
"4599",FALSE,FALSE,"Paul Zipser",1627835,1,2016,2017
"4600",FALSE,FALSE,"Ante Zizic",1627790,2,2017,2019
"4601",FALSE,FALSE,"Jim Zoet",78647,0,1982,1982
"4602",FALSE,FALSE,"Bill Zopf",78648,0,1970,1970
"4603",TRUE,FALSE,"Ivica Zubac",1627826,4,2016,2020
"4604",FALSE,FALSE,"Matt Zunic",78650,0,1948,1948
